(Be) over one's head: ser difícil para alguém
(Like) looking for a needle in a haystack: procurar uma agulha num palheiro
(You're) welcome: de nada
... Of hers: dela
... Of mine: de mim
A bunch of: um monte de
A day: por dia
A dime: 10 centavos
A few blocks away: poucos quarteirões daqui
A good deal of: grande quantidade 
A good many: muitíssimos, muitos
A good number of: um grande número de
A great many: muitos, muitíssimos, um grande número de
A great number of: um grande número de
A great quantify of: grande quantidade
A hard time: dificuldade
A large number of: um grande número de 
A large quantify of: grande quantidade 
A little bit: um pouquinho
A lot of (lots of): uma porção de, muitos, muito, um grande número de, grande quantidade
A lot: muito
A never-to-be-forgotten day: um dia inesquecível
A nickle: 5 centavos
A pain in the neck: um pé no saco
A pair of breeches: calção
A pair of pincers: torquês, pinça, alicate
A pair of tongs: tenaz, pinça
A pair of tweezers: pinça
A penny: um centavo
A quarter: 25 centavos
A wonderful time: um tempo maravilhoso (divirta-se muito)
Abandon: abandonar
Abbess: abadessa
Abbot: abade
Abbs: abdominais (exercício)
Abide: habitar
Ability: habilidade
Able: capaz
About to: próximo a (acontecer)
About: sobre, a respeito de; aproximadamente; daqui para lá
Above: acima de
Abroad: no, ao estrangeiro, fora do país, no exterior, outro país
Absence: ausência, falta
Absent minded: distraído, desligado
Absent: ausente
Absentee: quem está ausente
Abstinency: abstinência
Abundant: abundante
Abuse: abuso; linguagem injuriosa, desaforos
Accent: sotaque, acento, acentuar
Accept: aceitar
Accident: desastre
Accommodate: acomodar
Accompany: acompanhar
According to: de acordo com, conforme (indica fonte de informação), segundo
Account: conta, consideração, relato
Accountant: contador
Accounting: contabilidade
Accumulate: acumular
Accuracy: precisão
Accurate: certeiro, acurado, cuidadoso
Accuse: acusar
Accustom: acostumar
Accustumed: acostumado
Ache: dor, doer
Achieve: atingir, alcançar
Acomplish: conseguir, concluir
Acquire: adquirir
Across from: do outro lado (em frente)
Across: do outro lado
Acrylic: acrílico
Act: agir, atuar, proceder, ato, lei
Active: ativo
Actually: na verdade
Ad: advertisement: propaganda, anúncio
Adam's apple: pombo de Adão
Add: acrescentar, juntar
Addict: viciado
Addiction: vício
Addition: acréscimo
addressee: endereçado
Adept: perito, adepto
Adjoining room: quarto adjunto
Adjourn: adiar, suspender
Administrator: administrador
Admire: admirar
Admit: admitir
Advance: avançar
Advantage: vantagem
Advertisement: anúncio, propaganda
Advertising: propaganda
Advices: informações, relatório
Advise: avisar, aconselhar, informar
Aerobic: aeróbica
Aesthetic: estético
Affair: assunto
Affect: afetar
Affirm: afirmar
Afford: aguentar, suportar, proporcionar, dar, permitir-se, dar conta, bancar, manter
After all: afinal
After events: acontecimentos posteriores
Afterwards: depois
Again and again: repetidamente
Age: envelhecer 
Aged: idoso
Agendum: agenda
Aghast: horrorizado
Agreeable: agradável
Agressor: agressor
Agricultural: agrícola
Agriculture: agricultura
Aha: oba
Ahead: à frente, adiante, adiantado (relódio)
Aid: auxiliar, ajuda, prestar auxílio
Aim: propósito, finalidade, alvo, objetivo, apontar
Air conditioner: ar-condicionado
Air vent: ventilação de ar
Aircraft: avião
Airmail: via aérea
Air-screw: hélice
Airways: linhas aéreas
Aisle seat: assento do corredor
Aisle: ala, corredor (igreja, aeronave, teatro, ônibus, loja)
Also known as (AKA): também conhecido como
Akin: aparentado
Alack: uma falta
Alarm clock: despertador
Alas: infelizmente
Algebra: álgebra
Alight: acesso
Alike: semelhante
All along: o tempo todo
All at once: de uma vez, subitamente
All but dead: quase morto
All day long: o dia todo
All day: o dia todo
All of a sudden: subitamente 
All of them: todos eles (elas)
All over te world: em todo o mundo
All over: por toda
All the same: tanto faz, não faz diferença
All to your liking: tudo está do seu agrado
Allegiance: fidelidade, lealdade
Allow: permitir
Allowance: concessão, desconto, mesada
Almond: amêndoa
Almost nil: quase nada
Alms: esmola
Along the way: pelo caminho
Along: ao longo de
Also: também, além disso
Alter: alterar
Although: embora, apesar de
Alumni: ex-alunos
Alumnus: ex-aluno
Amateur: amador
Amaze: surpreender, assombrar
Amazed: espantado, maravilhado
Amazing: ótimo, excelente, maravilhoso, espantoso, inacreditável 
Ambassador: embaixador
Amenities: comodidades, facilidades
Amiable: amável
Amid: ao longo de, por
Amidst: ao longo de, por
Amis: erroneamente
Amount: quantidade, quantia
Ample: espaçoso
Amputate: amputar
Amusement park: parque de diversão
Amusing: divertido
An arm and a leg: olhos da cara, muito caro
An off chance: uma probabilidade remota
An off day: um dia de folga
An off issue: uma questão secundária
An off season: uma estação morta
An off street: uma rua lateral, uma rua afastada
Analogous: análogo
Analyses: análises
Analysis: análise
Ancestor: ancestral
Anchor: âncora, ancorar
Ancient: antigo
And so on: e assim por diante
And that's why: e é por isso que
And the like: similares
And you: e você?
Anger: raiva, cólera
Animosity: antipatia, animosidade
Ankle: tornozelo
Annals: anais
Announce: anunciar
Announcement: anúncio
Annoyance: chateação, aborrecimento
Annoying: aborrecedor, aborrecendo
Answer for: responder por, ser responsável por
Antenna: antena
Anterior: anterior
Antique: antigo, antiguidade
Anxiety: ansiedade
Anxious: ancioso
Anybody else: outro qualquer
Anyhow (realce, reforço): de qualquer modo, de algum modo, de alguma forma
Anyway: de qualquer modo, de algum modo
Apologise: pedir desculpas
Apologize (mais rebuscado): sinto muito, desculpa
Apology: desculpa, apologia
Apostrophe: apóstrofo
Apparent: aparente
Appeal: recurso, apelo, apelação, apelar, recorrer
Appearance: aparência, aparecimento, aspecto
Appetizer: aperitivo
Applaud: aplaudir
Apple of my eyes: menina dos meus olhos
Apple tree: macieira
Appliances: eletrodomésticos
Applicable: aplicável
Apply to (apply): dirigir-se a
Apply: candidatar, aplicar
Appoint: marcar, agendar
Appointed: marcada
Appointment book: agenda (em inglês): agenda
Appointment: nomeação, compromisso, designação, consulta, entrevista, encontro, agendamento
Appreciate: apreciar
Approach: abordagem, aproximar-se
Appropriate: apropriado, adequado, próprio
Approve: aprovar
Apt: apto, oportuno, propenso
Arch: arco
Archipelago: arquipélago
Are you serius?: você está falando sério?
Argue: discutir (sentido de argumentar), brigar, argumentar
Arise: levantar, surgir
Arm in arm: de braços dados
Armchair: poltrona
Armored cars: carros blindados, tanques blindados
Armour: armadura
Armset: braço do assento
Army: exército
Around here: por aqui
Around: ao redor de, em volta de, por todos os lados, rodeado por, em volta, redondeza
Arranged: progromado
Arrangements: planos, combinação, arranjos
Arrested: preso
Arrival: chegada
Arrive at the explanation or solution: chegar a uma explicação ou solução
Arrow: flecha, seta
As a matter of fact: de fato
As a result: como resultado, em consequência
As a rule: em regra, geralmente
As cold as ice: frio como gelo
As dry as a bone: seco como farinha
As early as: desde
As far as: até (se refere a distância)
As for: quanto a
As I: assim que
As if: como se
As like as not: provavelmente, com toda a probabilidade
As long as: contanto que, desde que
As many... as: tantos... quanto
As soon as possible (ASAP): tão logo quanto possível, com urgência, assim que possível
As soon as: assim que, tão logo que, logo que
As though: como se
As to: quanto a
As usual (as always):  como de costume, como sempre, pra variar
As well as: assim como, não só... Mas também
As well: também
As yet: até agora
As: quanto, ao que
Ascertain: averiguar
Ashamed: envergonhado
Ash-coloured: cinzento
Ashen: lívido, cinzento, cinéreo
Ash-gray: cinzento
Ashore: na praia, em terra firme
Ashtray: cinzeiro
Aside: de lado
Asleep: adormecido, dormente, entorpecido
Asparagus: aspargo
Aspirine: aspirina
Assignment: tarefa
Assist: assistir
Assistant: assistente
Assortment: sortido
Assure: assegurar
Astonished: atônito, pasmo, surpreso
Asylum: asilo
At a discount: com disconto
At all: sem dúvida nenhuma, nem um pouco, de jeito nenhum, de forma alguma, mesmo, absolutamente
At anchor: ancorado
At any moment: a qualquer momento
At any time: a qualquer momento
At arm's lenght: a distância
At around: mais ou menos
At each other: um ao outro
At first: a princípio
At his wit's end: completamente desorientado
At least: ao menos, pelo menos
At length: finalmente, por fim, afinal de contas
At loggerheads: em desavença
At night: à noite
At noon: ao meio-dia
At once: de uma vez, imediatamente
At present: atualmente, no momento
At random: ao acaso
At risk: em risco
At short notice: em breve prazo
At that time: naquela hora
At the back of: atrás de
At the break: no intervalo
At the head of: no topo de
At the most: no máximo
At the seaside: à beira mar
At this moment (At this time): neste momento
At times: às vezes, eventualmente, de vez em quando 
Atendee: quem assiste, quem está presente
Athlete: atleta
Attack: ataque
Attain: atingir, alcançar, conseguir
Attempt: tentativa, esforçar, tentar
Attend: assistir, assessorar, acompanhar, atender, frequentar, participar
Attendance sheet: folha de chamada
Attendant: frentista
Attentive: atento
Attic: ático, sótão
Attorney: advogado
Attraction: atração
Auction: leilão
Audience: auditório, platéia
Augment: aumentar
Aunt: tia
Auspices: auspícios
Authorize: autorizar
Automaton: autômato
Avail oneself: valer-se
Avail: aproveitar, proveito
Available: disponível, acesssível
Avenue: ave
Average: media
Aviary: viveiro, aviário
Avoid: evitar; escapar de, fugir
Await: esperar, aguardar
Awake: acordar, levantar-se
Aware: atento, ciente, informado
Away from: fora de
Away: longe
Awe: temor
Awesome: impressionante, incrível 
Awe-stricken: aterrado, apavorado
Awful: horrível
Awkward: desconfortável, incomodado, estranho, bizarro
Axe: machado
Axes: eixos
Axis: eixo
Aye: sim
Babysit: cuidar de crianças
Bachelor: homem solteiro
Bacilli: bacilos
Bacillus: bacilo
Back and forth: para frente e para trás, de um lado para outro
Back door: porta de trás
Back of my hand: como a palma da minha mão
Back seat driver: copiloto
Back then: lá atrás (tempo)
Back: de volta, para trás; costas, dar ré, em resposta
Background: fundo
Backpack: mochila
Backseat: banco de trás
Backwards: de trás para frente
Backyard: jardim dos fundos
Bacteria: bactérias
Bacterium: bactéria
Bad lunch: má sorte
Bad-humored: mal-humorado
Baggage claim: coleta de bagagem
Baggage tracing bag: local de extravio de malas
Baggage: bagagem
Bail: fiança
Bailable: afiançável
Bake: assar (alimentos moles, endurece, muda a consistência), cozer
Baker: padeiro
Baking dish: assadeira (louça para assar)
Baking pans: assadeiras (formas para bolo, pão)
Balcany: sacada
Bald: careca
Bald-headed: calvo
Bale: fardo
Ball: bola, baile
Balloon: bexiga, balão
Band: bando
Bandana: bandana
Bandit: bandido
Bank: margem; banco
Bankrupt: quebrar (falência), falência
Bankruptcy: bancarrota, falência
Banner: bandeira, faixa
Bar: barra
Barbecue: churrasco
Barber: barbeiro
Bare: nu; descobrir
Barely: mal, apenas, quase não
Bargain: pechincha
Bark: latir; cortiça
Barking dog: cachorro que ladra
Barley: cevada
Barn: celeiro, estábulo, cocheira
Baron: barão
Baroness: baronesa
Barrel: barril
Barrier: barreira
Bars: barras
Base: base, basear
Basement: subsolo, porão
Bases: bases
Basis: base
Bat: morcego, taco (baseball)
Bath: banho
Bathe: banhar
Baton: batuta, bastão
Batter: base de uma mistura (massa)
Battle: batalha
Bay: baía
B-Day: aniversário
Be able to: poder, conseguir, ter a capacidade de
Be about to: estar prestes a 
Be afraid of: ter medo de
Be and the same boat: estar no mesmo barco, ou seja, estar na mesma situação
Be at a loss: estar em dificuldade
Be at sixes and sevens: estar confuso
Be back: estar de volta
Be born: nascer
Be hungry: ter fome
Be in a position to: estar em situação de
Be looking up: estar melhorando
Be of good cheer!: tenha ânimo!
Be on the watch: estar na espreita
Be over: terminar
Be right: ter razão
Be short on looks: visualmente sem atrativo algum
Be sleepy: ter sono
Be worth: valer a pena
Be wrong: não ter razão
Beak: bico
Beam: raio de luz, viga
Bear: urso; suportar, gerar; dar à luz; produzir; nascer; carregar
Beard: barba
Bearer: portador
Beast: fera, besta, animal
Beat up old car: carro velho
Because of: devido a, por causa de
Become the fashion: ficar na moda
Become: tornar-se
Bed and breakfast (BB): aluga-se quarto para viajantes
Bedspread: colcha
Beef: carne, gado
Beg: rogar, implorar, pedir, mendigar
Beget: gerar
Beggar: mendigo
Beggar-man: mendigo
Begger: mendigo
Behalf: lado
Behave: comportar-se
Behavior: comportamento
Behind my back: pelas minhas costas
Behind: atrasado (relógio), atrás de
Behold: olhar, contemplar
Being: ser (subst.)
Belief: crença
Believe in: acreditar em (um fato); ser favorável a (uma ação); confiar em (pessoa)
Bell-boy: carregador (hotel)
Belong in: pertencer a (lugar), fazer parte de
Belong to: pertencer a, ser próprio de, competir a
Belong: pertencer
Belongings: pertences, acessórios
Beloved: querido
Below: debaixo de, abaixo
Belt: cinto, faixa (arte marcial)
Beltway: anel viário
Bench: banco
Bend forward: inclinar-se para a frente
Bend: dobrar, curva, curvar, inclinar, desviar
Benefit: benefício
Benevolence: benevolência
Bereave: privar de, despojar
Beseech: suplicar
Beside: ao lado de
Besides: Além de, alé disso
Bespeak: encomendar
Bestir oneself: atarefar-se
Bestride: cavalgar, montar sobre
Bet: apostar
Betake oneself (to): dirigir-se (para), ir (a)
Betimes: a tempo
Betrayal: traição
Beverage: bebida
Beyond reach of: fora do alcance de
Beyond: além de
Bid: mandar, ordenar; fazer oferta; dar lance em leilão
Bike: bicicleta, moto
Bill board: painel de propaganda (no Brasil é outdoor)
Bill: conta, cédula
Billiards: bilhar
Billy-goat: bode
Bind: atar, encadernar; amarrar; juntar; vincular
Binoculars: binóculo
Bit: porção, bocado, pouco
Bitch: cadela (gênero de cachorro e ofensa)
Bitten off: arrancada
Bitter-sweet: acre-doce
Blackberry: amora
Blackbird: melro
Bladder: bexiga (órgçao)
Blade: lâmina
Blame: culpa, culpar, censurar
Blank look on (one's) face: olhar apático
Blanket: cobertor
Blast: estouro, explosão
Blend: misturar, unir-se
Bless you: saúde
Bless: benzer
Blest: bendito
Blinker: seta, pisca-pisca, pisca
Block: engarrafamento (de tráfego)
Blocking: bloqueio
Blond: loira
Blow up: soprar; explodir, inflar
Blueprint: planta (arquitetura)
Boar: javali, porco (masc.)
Board: borda, mesa, tabuleiro, conselho, quadro
Boarding pass: passe para embarque
Boarding-house: pensão
Boast: ostentar
Boat: barco (qualquer tipo com menor dimensão)
Body builder: fisiculturista
Boiled eggs: ovos cozidos
Boiling: fervendo, fervente
Bold: negrito; corajoso, ousado
Boldly: audaciosamente
Boldness: ousadia, audácia
Bolt: raio (vai para terra)
Book shop: livraria
Book: fazer uma reserva, livro
Book-case: estante
Booking: reserva
Bookish: livresco
Booklet: folheto, brochura, livreto
Bookshelf: bookcase: estante
Bookstore: livraria
Boom: explosão, desenvolvimento rápido
Boon: benefício, bênção, dádiva
Boost: melhorar
Boot: bota
Border: limite, fronteira
Bored: aborrecido, entediado
Boredom: tédio
Born: nascido, nato
Borrow: pedir emprestado
Botanical: botânico
Both ... And: não só... Mas também, tanto... Quanto/como, ao mesmo tempo que
Bother: maçar, incomodar
Bottle opener: abridor de garrafa
Bottom: fundo
Bough: galho
Bought it for peanuts: compraram por uma milharia
Boundary: limite, fronteira
Bounds: limites
Bow tie: gravata borboleta
Bow: arco, curva
Bowels: entranhas
Bowl: tigela
Bowls: boliche
Boxers: cuecas
Briefs: cuecas
Boyhood: infância, juventude
Bra: sutiã
Brace: braçadeira
Bracelet: bracelete
Brackets: colchetes
Braids: tranças
Brake: breque, freio
Branch house: filial
Branch: ramo, filial; ramificar, tronco
Brand: marca
Brass: latão
Brat: pirralho
Bravery: bravura
Breach: ruptura
Breadth: hálito, largura
Break away: fugir
Break down: demolir; fracassar, falhar, enguiçar, quebrar, enfraquecer, perder as forças; irromper em pranto
Break in period: intervalo de tempo
Break in: interromper, introduzir-se
Break into: arrombar, invadir
Break off: interromper, parar, cessar; romper relações
Break out: desobstruir, irromper, expandir
Break through: arrombar, demolir
Break up: romper, partir, ir-se embora, dispersar-se, fragmentar-se, terminar
Breast feed: amamentar
Breast: seio
Breeches: calção
Breed: gerar, criar
Brethen: irmãos (de uma seita)
Brew: preparar
Bricklayer: pedreiro
Bride: noiva
Bridegroom: noivo
Brief: sumário, resumo
Briefcase: pasta
Bright: brilhante
Brightness: brilho
Brilliant: brilhante
Bring about: causar
Bring back: traz de volta, devolver
Bring on: induzir 
Bring the dicussion to an end: encerrar a discussão 
Brisk: rápido
Broad: grande, largo
Broadcast: transmitir
Broad-minded: mente aberta
Brochure: brochura, panfleto (parecido com booklet)
Broil: grelhado
Brooch: broche
Brook: ribeiro, riacho, córrego; tolerar, permitir 
Broom: vassoura
Brother-in-law: cunhado
Bruise: contusão (fica roxo), luxação, hematoma, machucado
Brunch: refeição entre o breakfast e o lunch
Brush: escova, pincel
Buck: paus, mangos, dólar, pila, conto
Bucket list: lista de coisas a fazer antes de morrer
Buckle: fivela
Buddy: camarada, parceiro, amigo
Budget: orçamento, orçar
Bug: chatear, perturbar (gíria), incomodar, inseto
Build on: construir sobre, apoiar-se em
Bullet train: trem bala
Bump: colisão, colidir, bater
Bumper: parachoque
Bumpy: acidentado
Bun: pão de hamburguer, pão doce, coque (cabelo)
Bunch: punhado, um monte
Burden: carga, fardo, peso
Bureau: escrivaninha, escritório comercial
Bureaus: escrivaninhas, escritórios comerciais
Bureaux: escritórios
Burglar: assaltante, ladrão
Burglary: roubo
Burlesque: caricato, burlesco
Burnt: queimado
Burst into tears: cair em prantos
Burst into: invadir
Burst: arrebentar; romper; irromper; explodir
Bury: sepultar, enterrar
Bus station: rodoviária
Bush: arbusto
Bushy: cheio de arbustos
Busily occupied: muito ocupado
Business hour: horário comercial
Busybody: bisbilhoteiro
But: além de, mas
Butcher shop: açougue
Butcher: açougueiro
Butler: mordomo
Butt: bumbum
Buttocks: nádegas
Buy (for - from): comprar
Buzz: zumbir
By all means: certamente
By and by: em breve
By and large: em conjunto
By chance: por acaso
By dint of: à força de, a poder de, por meio de
By fits and starts: ininterruptamente, aos arrancos, aos trancos e barrancos
By hand: à mão
By means of: por meio de, mediante
By no means: de maneira alguma
By noon: até meio dia
By now: neste momento
By that time: até aquele momento
By the end of the: até o final da
By the evening: até a noite, à noite
By the time: no momento, no tempo em que
By the way: à propósito
By themselves: sozinhos
By: junto a
C'mon: qual é, vamos lá
Cab: taxi 
Cabaret: espetáculo, cabaré
Cabbage: repolho
Cabin: cabine (local dos passageiros), cabana
Cabinet: gabinete, armário
Cacao: cacau
Cactus: cacto
Cage: jaula
Calculate: calcular, presumir
Calf: bezerro, panturrilha
Call at: visitar, parar em, telefonar para
Call for: requerer, exigir
Call me up: me ligar, me telefonar
Call off: cancelar
Call on: visitar, apelar para, recorrer a 
Call the attention: chamar atenção (chamar responsabilidade)
Came up: surgiram
Camp: acampamento, acampar 
Campaign: campanha
Campfire: fogueira
Camping: acampamento, acampar
Can able to: poder, conseguir, ter a capacidade de
Can opener: abridor de lata
Cancel: cancelar 
Candlelight: luz de uma vela
Candy: doce
Cap: boné
Capable: capaz
Cape: cabo
Car crash: acidente de carro
Car rental: locadora de automóveis
Cardigan: casaco de lã
Cardiologist: cardiologista
Care: cuidadoso, importar-se
Career: carreira
Careful: cuidadoso
Careless: descuidado, negligente
Cargo: carga
Carousel: esteira (malas)
Carpenter: carpinteiro
Carpet: tapete
Carriage: carruagem
Carrot: cenoura
Carry on: continuar
Carry out: obedecer, realizar 
Cart: carroça
Cartoon: desenho animado
Carve: entalhar
Case: caso, estojo, caixa, caixote
Cash: dinheiro (à vista), grana, descontar
Cashier: caixa
Casket: caixão
Cast: lançar, elenco
Cat can look at a king: ninguém é mais que ninguém
Cat-and-dog life: um vida de cão com gato
Catch: pegar, capturar, apanhar, pegadinha
Cattle: gado
Caught: preso, apanhado
Cauliflower: couve-flor
Cause offence: offender
Cease: parar, cessar
Ceiling: teto
Celebrate: celebrar, comemorar
Cello: violoncelo
Censer: incensário, porta-incenso
Census: censo
Center table: mesa de centro
Certain: certo
Certainly: certamente
Certificate: certificado
Chain saw: serra elétrica
Chair men: presidentes
Chalk: gesso, calcário, giz
Chalkboard: quadro de giz, lousa
Challenge: desafiar, enfrentar, desafio
Chambermaid: camareira
Championship: campeonato
Chandelier: candelabro, lustre
Change: trocar
Channel: canal
Character: caráter, personalidade, personagem
Characterize: caracterizar
Charge: cobrar, a cobrar, carregar, carga, taxa, custo
Charity: caridade
Charm: charme, encanto; amuleto
Chase away: afugentar, afastar
Chase: perseguir, perseguição
Chauffeur: motorista
Cheap: barato
Cheat: enganar, trapacear, colar (fila)
Check in: dar entrada
Check out: dar saída
Check: conta, verificar
Checkers: jogo de dama (USA)
Cheek to cheek: rosto colado
Cheek: bochecha
Cheer up:levantar o moral, pôr bem disposto
Cheer: alegria, torcer, alegrar, animar
Cheese: queijo
Chemist's: farmácia
Chest of drawers: cômoda
Chest: peito
Chestnut: castanha
Chew: mascar, mastigar
Chicken: frango
Chide: repreender
Chief: chefe, principal
Childhood: infância
Childish: infantil, peuril, tolo
Childlike: infantil, próprio de criança, inocente
Children: kids: filhos (daughter + son)
Chimney: chaminé
Chimpanzee: chimpanzé
Chin: queixo
China: porcelana, China
Chip: lasca
Chop chop: rapidinho
Chop your hand off: cortar sua mão fora
Chop: picar
Chopper: helicóptero
Chores: afazeres
Christian name: primeiro nome
Chubby: fofinho
Cinema: cinema
Cinnamon: canela (tempero)
Cipher: zero (sentido figurado); cifra
Circumference: circunferência
Circumstance: circunstância
Citizen: cidadão
Citizenship: cidadania
City hall: prefeitura
Civilized: civilizada
Claim: reclamação, reclamar, reivindicar
Clarinet: clarineta
Classical music: música clássica
Classmate: colega de classe
Claw: garra
Cleaning products: produtos de limpeza
Clear: claro
Clearance: despacho
Cleave: aderir; rachar, separar, partir-se
Clergyman: clérigo
Clever: inteligente, hábil, esperto
Cliff: penhasco
Climate: clima
Climax: clímax, apogeu
Climb: subir, trepar, escalar
Cling: agarrar-se
Clipboard: prancheta
Clog: entupir
Close the door: feche a porta
Close to the wings: portas de emergência
Close to: junto a, pegado a, perto
Closet: cômodo da casa
Closing time: horário de encerramento, fim do expediente
Closing: desfecho
Cloth: tecido, pano
Clothe: vestir; roupa(s)
Clothing store: loja de roupas
Clothing: vestuário, roupa
Cloudy: nublado
Clumsy: desajeitado, pesado
Clutch: embreagem
Coal: carvão
Coastwise: ao lado da costa
Coat: paletó, casaco
Cock: galo 
Cockpit: cabine
Cod fish: bacalhau
Cod: bacalhau
Code: código
Coffee nachine: cafeteira
Coffee pot: cafeteira
Coffee table: mesa de centro
Coffin: caixão
Coif: coifa
Coil: bobina, serpentina, enrolar
Coin: moeda
Colander: escorredor de macarrão
Colar: coleira
Cold cuts: frios
Cold: resfriado
Colect: cobrar
Collar: coleira
Colleague: colega
Collect: colecionar
College Entrance Examination: exame vestibular
College: colégio, faculdade
Collegial: colegial
Collide: colidir
Colloquial: coloquial
Colon: dois pontos
Colonist: colono
Colours: bandeira (navio, regimento; partido, opinião; cores)
Column: coluna
Comb: pentear
Come across: encontrar, achar por acaso
Come away: vir embora, desprender-se, partir
Come back: voltar (dentro)
Come by: visitar, aproximar-se e passar
Come down: vir para baixo, venha para baixo, descer, cair, desmoronar-se
Come from: vir de (procedência)
Come handy: vir a ser útil, vir a calhar, vir em boa hora
Come in: entrar, venha para dentro
Come into: entrar; entrar na posse de
Come my way: vir na minha direção
Come off: escapar, sair, surgir, desprender-se
Come out: sair, desaparecer, venha para fora
Come over: cobrir, comandar, dominar
Come round: mudar de ideia
Come through: vir através de
Come up: vir para cima, venha para cima, subir
Comet: cometa
Coming Monday: próxima segunda
Coming our way: vindo em nossa direção
Coming out: saindo 
Comma: vírgula
Command: comandar
Commence: começar
Committed: cometido
Committee: comissão
Common: comum
Commonly: facilmente, comumente
Community: comunidade
Commute: mover-se, deslocar-se
Companion: companheiro
Company: empresa, companhia
Compare: comparar
Comparison: comparação
Compass: bússola
Compasses: bússolas; compasso (instrumento)
Compel: compelir
Complain: reclamar
Complaint: queixa, queixar, lamentar-se
Complete name: nome completo
Complicity: cumplicidade
Compliment: cumprimentar, saudar, elogio
Compose: compor (constituir)
Composition: redação
Conceal: esconder
Concerning: concernente, a respeito de
Concession: concessão
Conch: concha
Conclude: concluir
Conclusive: conclusiva
Concordance: concordância
Concur: concorrer
Conductor: maestro
Confer: conferir
Confide: confiar
Confidence man: vigarista
Confidence: confiança
Confidences: confidências
Confident: confiante, seguro
Conflict: guerra, conflito
Confuse: associar-se; confundir
Connect: conectar, ligar
Conquer: conquistar
Consider: considerar
Considerate: atencioso, considerado
Consist: consiste
Consolidate: consolidar
Constant: constante
Consumption: consumo
Contact: contato
Contain: conter
Content: contente
Contents: conteúdo
Conter: balcão
Contest: competição, campeonato
Context: contexto
Continue: manter, continuar
Controversy: controvércia, polêmica
Contry-house: casa de campo
Convention: convenção
Conversation: conversação, conversa
Convertible: conversível
Convey: transmitir
Conveyor belt: bagagem de mão
Convince: convencer
Cook: cozinheiro, cozinhar
Cooker hood: exaustor
Cookie: biscoito
Cooking: culinária
Coordinator: coordenador
Cope: cúpula
Copper: cobre
Coppers: moeda
Copyright: direito autoral
Cork screwer: saca rolhas
Corn field: milharal
Corn meal: fubá
Corn on the cob: espiga de milho
Corpse: cadáver
Correct: corrigir
Correspond: corresponder
Corrupt: corrupto
Corruption: corrupção
Cost: custar, causar prejuízo
Cottage: casa de campo, chalé
Cotton buds: cotonetes
Couch: sofá
Cough drop: pastilha (tosse)
Cough: tosse
Count: conde
Countdown: contagem regressiva
Counter: caixa (de um banco), contador, balcão; contrariar
Counterfeit: falsificação
Countess: condessa
Country: país
Countryside: interior, zona rural
Couple: par
Course: curso
Court: corte, tribunal
Courtroom: tribunal
Cousine: cozinha, culinária
Cover: cobrir, tampa, cobertura, capa
Covet: cobiçar
Coward: covarde
Crab: caranguejo
Crack: rachar, quebrar, fenda, estralar
Cracker: surpresa
Crackers: bolachas
Cradle: berço
Crash: abater, cair, colisão, batida, bater (carro)
Crave attention: chamar atenção (com alguma coisa)
Crayon: giz de cera
Creep: arrastar-se, engatinhar
Creepy: assustador
Crew: tripulação
Crib: manjedoura, berço
Criminal law: direito penal
Crippled: aleijado
Crises: crises
Crisis: crise
Criteria: critérios
Criterion: critério
Criticize: criticar
Crooked: torto
Crop: colheita
Cross: cruzar, atravessar, cruz
Crosswalk: faixa de pedestre
Crossword puzzle: palavras cruzadas
Crossword: palavras cruzadas
Crowd: multidão
Crowded: lotada, congestionada
Crucial: crucial
Cruise: cruzeiro
Crum: esmigalhar
Crumble: esmigalhar(-se), pulverizar(-se), desmoronar(-se), desintegrar(-se)
Cucumber: pepino
Cue: sugestão, dica
Cuff: punho
Culprit: réu
Cupboard: armário de cozinha
Curb: calçada; meio-fio, freio; controlar
Curl: ondulação, cacho, caracol, enrolar, encaracolar
Curly hair: cabelo encaracolado, crespo
Currency: moeda (sistema monetário)
Current: atual, atualmente
Curse: amaldiçoar
Cursed: maldito
Curtain: cortina
Curve: curvar
Cushion: coxim, almofada
Customer: cliente, freguês
Customs official: fiscal da alfândega
Customs: costumes, hábitos; impostos alfandegários
Cut off: amputar 
Cut out: eliminar, cortar 
Cute: carinhoso, fofinho, bonitinho
Cutlery: talher
Cutting board: tábua de cortar
Daggers: adagas, punhal
Daily: diariamente
Dale: pequeno vale
Damage: danificar, estragar
Damages: indenização
Dame: dama
Damn: maldição, maldito
Damp: úmido
Dandy: dândi
Dangerous: perigoso
Danish: dinamarquês
Dare: ousar, atrever-se, desafiar
Dark circles: olheiras
Darker and darker: cada vez mais escuro
Darkness: escuridão
Darn: droga
Dash: traço, colisão; colidir, travessão (pontuação)
Dashboard: painel
Data: dados
Date back to: data de
Dating: namoro
Datum: dado
Daughter: filha
Dawn: aurora, ao amanhecer, madrugada
Day off: dia de folga (trabalho)
Daybreak: raiar o dia, aurora, madrugada
Day-by-day: dia a dia
Day-dreamer: sonhador
Dazzling: ofuscante, deslumbrante, estonteante
Dead end street: rua sem saída
Dead wrong: redondamente enganado
Deadline: tempo limite
Deadly: mortal, mortífero
Deaf: surdo
Deafening: ensurdecedor
Deal: negociar, tratar, lidar (com)
Dealership: concessionária
Dean: reitor universitário
Dearest: queridíssimo
Deathbed: leito de morte
Debt: dívida
Decade: década
Decay: decadência, desfalecimento
Deceased: morto, falecido
Deceitful: desonesto
Deceive: decepcionar, enganar
Decelerate: desacelerado
Decide: decidir
Declaration: declaração
Declarte: declarar
Decline: declinar, negar
Decorate: ornamentar
Decree: decreto
Deed: ação, ato, feito, gesto, proeza, escritura
Deep: profundeza
Deer: cervo
Defend: defender
Defendant: réu
Defiant: desafiador
Deficient: deficiente
Definite: definido, definitivo
Defogger: desembaçador
Defraud: burlar
Defroster: descongelador
Degree: grau
Delay: adiar, demorar
Deliberate: deliberar
Delicate: delicado
Delight: deleite, prazer
Deliver: entregar
Delivery: entrega
Demand: demandar, pedir, exigir
Demanding: exigente
Demolish: demolir
Demonstrate: demonstrar
Demonstration: passeata
Dental floss: fio dental
Deny: negar
Department: departamento
Departure board: painel de embarque
Departure: saída, partida, embarque
Depend: depender
Dependable: confiável
Dependent: dependente
Depends on: depende de
Deposit: depositar, depósito
Depot: depósito
Deprived: privado
Deputy: deputado
Descend: descer
Descendant: descendente
Descentralize: descentralizar
Describe: descrever
Description: descrição
Deserve: merecer
Desk: cadeira (carteira), mesa (trabalho ou estudo), secretária, balcão
Despair: desespero
Despite of: apesar de + (verbo + ing: infinitivo)
Despite: apesar
Dessert: sobremesa
Destination: destino
Details: pormenores
Detain: deter
Deter: dissuadir, deter
Detest: detestar
Develop: desenvolver
Development: desenvolvimento
Device: aparelho
Devolve: devolver, delegar
Devote: dedicar
Diagram: diagrama
Dice: dados (jogo)
Did badly: sair-se mal
Did you mean it?: era sério?
Die for: morrer por (desejar ardentemente)
Diet: dieta
Differ: discordar, diferir
Difficult: difícil
Dig: cavar
Diligent: aplicado, estudioso
Dimly: com dificuldade
Diner: lanchonete, restaurante
Dinner-time: hora de jantar
Dint: força
Dip: patê
Dirt road: estrada (de terra)
Dirt: sujeira
Dirty: sujo
Disadvantage: desvantagem
Disappoint: disapontar
Disaprovement: desaprovação
Disastrous: desastroso
Discard: descartar, jogar fora
Disclose: revelar
Discord: discórdia
Discount: discontar
Discover accidentally: descobrir por acaso
Discover: descobrir
Discovery: descoberta
Discriminatory: discriminação
Discuss: discutir
Discussion: discussão, debate
Disease: doença
Disembark: desembarcar
Disgusting: nojento
Dish drainer: escorredor de louças
Dish: prato (receita), louça
Dishes: pratos, travessas
Dishwasher: máquina de lavar pratos
Dislike: não gostar
Dismissed: demitido
Disorganize: desorganizar
Disperse: dispersar
Disposal: disposição
Dispose: dispor, descarte
Disqualify: desqualificar
Disregard: deconsiderar, desprezar
Distort: distorcer
Distribute: distribuir
Disturb: incomodar, pertubar
Dive: mergulho, mergulhar
Diversion: desvio; diversão
Divide: dividir
Dividend: dividendo
Divorce: terminar, divorciar, separar
Do (something) over again: fazer de novo
Do (something) over and over: fazer de novo
Do a poll: fazer uma pesquisa
Do a Project: desenvolver um projeto
Do a puzzle: resolver um quebra-cabeça
Do business (with): trabalhar em negócios com
Do damage: causar danos
Do over: refazer 
Do overtime: fazer hora extra
Do research (on): pesquisar, fazer uma pesquisa (investigação científica)
Do so: para tanto
Do the cleaning (for): fazer limpeza
Do the cooking: cozinhar
Do the dishes: lavar os pratos
Do the laundry: lavar roupa
Do the right thing: ter uma atitude correta
Do the shopping: fazer compras
Do time in prison: cumprir pena carcerária
Do well (in): sair-se bem
Do your nails: fazer as unhas
Docile: dócil
Doctor's: consultório médico
Doggone it: caramba!
Dog-otter: lontra
Dome light: luz do teto
Dominate: dominar
Don't dare you: não ouse
Don't even look like (something): nem pense
Don't you even dare: nem mesmo ouse
Don't mention it: não há de que
Door man: porteiro
Double: dobro 
Doubtful: duvidoso
Dough: massa macarrão
Dowager: viúva, herdeira (de títulos ou de bens)
Dowdy: mulher desalinhada
Down hill: morro abaixo
Down sizing: enxugar (reduzir)
Down-fallen: derrubado, prostrado
Downhearted: abatido, deprimido
Downstairs: andar de baixo, em baixo, no térreo, para baixo, escada a baixo
Downtown: centro da cidade
Doze off: cochilar
Dozen: dúzia
Draft: esboço; saque
Drag: arrastar
Dragon fly: libélula
Dragonfruit: pitaia
Drake: pato
Draughts: correntes de ar; jogo de damas (UK)
Draw the attention: direcionar a atenção
Draw: desenhar; sacar (dinheiro), retirar; empate, direcionar, atrair
Drawer: gaveta
Dread: temer, medo, pavor
Dream of: sonhar com
Dreamy land: terra de sonhos
Dress up in costume: vestir uma fantasia
Dress up: vestir-se, fantasiar-se
Dress: vestido: vestir
Dresser: cômoda, penteadeira
Dressing: salad dressing: molho frio, molho de salada
Dressmaker: modista
Drip: pingar
Drive out of gear: dirigir na banguela
Drive over: atropelar
Driver's license: carteira de motorista
Driveway: entrada da garagem
Drone: zangão
Drop anchor: ancorar
Drop: deixar cair, cair, largar, soltar; gota 
Drown: afogar
Drunk: embriagado
Drunkard: bêbado, beberrão
Duches: duquesa
Dude: cara
Due to: devido a, em virtude de
Due: devido
Duke: duque
Dull: monótono
Duly: devidamente
Dump: descartar, despejar
During: durante
Dusk: cair da noite, crepúsculo
Dutiful: zeloso
Duty free shop: loja livre de imposto
Duty: dever
Dwarf: anão
Dwell: habitar, morar, existir
Dynamo: dínamo
Each other: um ao outro, um com o outro
Eager: ávido, ancioso
Ear: ouvido
Ear-deafening: ensurdecedor
Earl: conde
Earn: ganhar
Earring: brinco
Earthquake: terremoto
East: oriental, leste
Eastern: oriental, do leste
Eastward: em direção ao Leste
Easygoing: complacente
Eating: comendo, comida
Eaves: beiral
Edge: borda, beira, bordo, beirada
Educate: educar
Eel: enguia
Effective: efetivo
Effects: resultados; bens, pertences; fundos (capital, dinheiro)
Effort: esforço
Egg rolls: rocambole
Eggplant: berinjela
Ego: ego
Either one: qualquer um
Either... or: ou... ou, quer... quer
Either: também (frases negativas), um ao outro, uma ou outra, cada, também não (depois de negação)
Elbow: cotovelo
Elder: mais velho
Electric oven: forno elétrico
Electric razor: barbeador elétrico
Elementary school: primário
Elf: duende, elfo
Eligible: elegível
Eliminate: eliminar
Ellipses: reticências
Eloquence: eloquência
Elsewhere: em qualquer outra parte
Embarassed: envergonhado 
Embark: embarcar
Embrace: abrassar
Embroider: bordar
Emergency doors: portas de emergência
Emigrate: emigrar
Emit: emitir
Emperor: imperador
Emphasis: ênfase
Emphasize: enfatizar
Empire: império
Employ: empregar
Empowerment: empoderamento
Empress: imperatriz
Enchant: encantar
Encourage: encorajar
End table: mesa de canto 
End up: acabar (sentido de ter um fim)
End: fim, final, acabar, terminar, dar fim
Endeavour: esforçar-se
Endless: sem fim, infindáveis
Endurance: resistência
Endure: suportar
Energize: energizar
Engage: entrar (fazer parte), engajar, contratar, empenhar; noiva
Engaged: noivo
Engaging: atraente
Engine: máquina, locomotiva, motor
Enhance: realçar, aumentar, acentuar
Enjoy: gostar (sentido de curtir)
Enough talking: chega de falar
Enough: bastante, chega
Enquiry: informação
Ensured: garantido, assegurado, garantir, assegurar
Enter: entre, entrar
Entertained: entretido
Entertainment: entreterimento
Entire: toda, inteira
Entirely: inteiramente
Entitled: intitulado
Entrails: entranhas
Entrance hall: recepção, saguão
Entrance: entrada
Entrance-fee: entrada, taxa de entrada
Entrust: confiar
Envious: invejoso
Environment: arredores, meio ambiente
Epoch: época
Equal: igual
Eraser: borracha, apagador
Err: errar
Errand-boy: mensageiro
Errata: erratas
Erratum: errata
Error: erro (substantivo, normalmente para erros menores, não tão graves)
Escape: evitar; escapar de, fugir
Essay: redação, ensaio
Establish: estabelecer, fundar
Establishment: estabelecimento
Estimate: estimativa, estimar
Evacuate: evacuar
Evacuee: quem é retirado de área de risco
Eve: véspera
Even if: mesmo se, mesmo que, ainda que
Even or odd: par ou ímpar
Even so: mesmo assim
Even surface: superfície plana
Even though: ainda que, muito embora, mesmo que
Even: até mesmo, mesmo, até, inclusive, ainda, ainda mais, liso, plano, nivelar, equilibrar; empate; par
Even-handed: imparcial
Evening: fim de tarde, início de noite
Event: evento, acontecimento, caso
Eventually: finalmente
Ever again: nunca mais
Ever and again: repetidamente
Ever since: desde
Ever: já, alguma vez
Everlasting: eterno
Every other day: dia sim, dia não
Every single: cada, todo (single enfatiza)
Evidence: evidência, testamento; prova circunstancial
Evidences: vestígios de uma ocorrência
Evident: evidente
Evil: mau, malvado
Evoke: evocar, inspirar
Ewe: ovelha
Exaggerate: Exagerar
Exaggeration: exagero
Exam: exame, prova
Examination: exame
Examine: examinar
Examiner: examinador
Except: exceto 
Excepting: exceto
Exception: exceção
Exceptionally: extraordinariamente
Exchange: trocar (trocar entre si), câmbio
Excite: excitar, empolgar
Excitement: entusiasmo
Exclaim: exclamar
Exclamation mark: ponto de exclamação 
Exclamation point: ponto de exclamação
Executor: testamenteiro, executor
Exempt: isentar, dispensar, isento
Exercise-book: caderno, livro de exercícios
Exhausted: exausto, esgotado
Exhibit: exposição, exibição, exibir, apresentar, expor
Expand: expandir
Expect: esperar
Expense: despesa
Expert: especialista, perito
Expertise: perícia
Explain: explicar
Explanation: explicação
Explorer: explorador
Express: expressar
Exquisite: refinado, requintado
Extenuating: extenuante
Extra cash: grana extra
Extravagant: extravagante
Eye drop: colírio
Eyebrows: sobrancelhas
Eyelashes: cílios
Fable: fábula
Fabric: tecido
Face powder: pó de arroz
Face the music: encarar a realidade
Face: encarar (sentido de enfrentar)
Facility: facilidade, estrutura
Faculty: faculdade
Fade: murchar, debotar
Fail: falhar, faltar, ser reprovado
Faint: desmaiar, fraco, desmaio, débil
Fair: bonito, regular, médio, justo, razoável
Fairly well: razoavelmente, sofrivelmente
Fairy story: conto de fadas
Fairy: fada
Faithfully: fielmente
Fake: fingir
Fall asleep: cair no sono, pegar no sono, adormecer
Fall away: esvair, desaparecer
Fall down: desmoronar, baquear
Fall out: brigar
Fall over: tombar
Fall: queda
Falter: vacilar
Familiar: familiar
Family name: sobrenome
Fan: ventilador, abanar, ventilar, leque
Fancy you: que chique você
Fancy: pomposo, chique, extravagante, fantasia
Fanfare: fanfarra
Fantastic: estupendo, fantástico
Far and near: por toda parte 
Far and wide: por toda parte
Away from: distante, longe de
Far from: longe de
Far off: longe
Far: longe, longíquo, remoto
Faraway look: olhar distante
Faraway: longe
Fare: frete
Farewell: despedida, adeus
Far-fetched: rebuscado
Far-reaching: de grande alcance
Farther: mais distante 
Fashion: na moda
Fast: jejum, rápido
Fate: destino
Fatherly: paternal
Fatigue: fadiga
Faucet: torneira
Fault: falha, culpa
Favor: favor, favorecer
Favorite: favorito
Favourite: favorito
Fearful: temível, terrível, medonho, medroso
Fearless: destemido
Feast: festa
Feat: feito, façanha, proeza
Feather: pena, pluma
Featuring: apresentando, incluindo
Fee: taxa
Feel free: sinta-se à vontade
Fell off: cair (pendurado)
Fellow man: próximo
Fellow: companheiro, camarada
Fence: cerca
Fencing: esgrima
Ferry (boat): balça
Festivity: festividade, festa
Fetch: buscar
Fever: febre
Fiancé: noivo
Fiancée: noiva
Fiber: fibra
Fiddle: violino
Fief: feudo
Fierce: feroz
Fiercely: ferozmente
Fife: pífano, pífaro
Fig: figueira, figo, figa
Figure out: resolver, solucionar
Fill in: preencher (formulário ou questionário)
Fill out: preencher (formulário ou questionário)
Fill up: encher completamente
Filling: obturação, enchendo
Films: filmes (UK)
Fin: barbatana, quilha (prancha), estabilizador vertical (avião), aerofólio (carro)
Financial: financeiro
Find out: descobrir, saber
Fine: ótimo, bem, multa
Finger ends: extremidades do dedo
Fingerprints: impressões digitais
Fingertips: ponta dos dedos
Finish: terminar
Fire fighter: bombeiro
Fire fly: vagalume
Fire: fogo, incêndio, atirar, disparar
Firecracker: bombinha, fogo de artifício
Firefighter: bombeiro
Fireplace: lareira
Firestation: corpo de bombeiro
Firework: fogos de artifício
Firs stepped at the ballroom: pisaram pela primeira vez no salão
First aid kit: quite de primeiros socorros
First name: primeiro nome
Firstly: primeiramente
Fish Market: mercado de peixe
Fish: peixe 
Fisher: fisherman: pescador
Fist: punho
Fit: apto, em forma; caber; ajuste, adequado
Fitfully: intermitentemente
Fitness: forma física, aptidão
Fivefold: quíntuplo
Fix: consertar, fixar
Flame: chama
Flash: brilho, relâmpago
Flask: frasco
Flat tire: pneu furado
Flat: apartamento, vazio, fino
Flavor: sabor
Flea: pulga
Flee: fugir, escapar, abadonar
Fleet: frota
Flier: panfleto, folheto
Flight attendant: comissário de bordo
Flight: voar, voo, fuga
Fling: arremessar, atirar, lançar, mover-se com violência
Flip flop: chinelo
Float: flutuar
Flock: rebanho, bando
Flood: inundar, inundação, dilúvio
Floor drain: ralo
Floor plan: planta baixa
Floor: anda, chão
Floss: usar fio dental
Flour: farinha
Flu: gripe
Fluency: fluência
Fluent: fluente
Fluently: fluentemente
Flush the toilet: puxar a descargar
Flush: dar descarga
Fly into a passion: enfurecer-se
Fly over: sobrevoar
Foe: enemy: inimigo
Fog: neblina
Foggy: nebuloso
Fold up: enrolar, dobrar
Fold: dobra, dobrar
Folder: folheto, pasta (dobrado)
Folklore: folclore
Following: seguinte
Fond: afeiçoado
Food: alimento
Fool: tolo, idiota, bobo, louco; enganar
Foolish: bobo, insensato, tolo
Foostep: pegada
Foot the bill: pagar a conta
Foot: pé (parte do corpo); pé (medida); base; sopé; infantaria, soldados de infantaria
Footsteps: degraus
For ages: por décadas, por épocas
For all intents and purposes: para todos os efeitos
For as long as: por tanto tempo quanto, durante o tempo que
For charity's sake: por caridade
For ever and a day: para todo o sempre
For example: por exemplo
For God's sake: pelo amor de Deus
For instance: por exemplo
For now: por enquanto
For safety reasons: por segurança
For sale: a venda
For so long: por tanto tempo
For some exercise: como exercício
For the purpose: para esse fim
For the sake of: em atenção a, por amor de, devido a
For the time being: por ora, por enquanto
Forbear: abster-se
Forbid: proibir 
Forearm: antebraço
Forehead: testa
Foreign: estrangeiro
Forename: primeiro nome 
Foreseen: previsto
Forever and ever: para todo o sempre
Fork: garfo
Form: forma, formulário, formar, formato 
Formal: formal
Former: antigo, primeiro, anterior
Formerly: outrora
Formula: fórmula
Forsake: abandonar
Fortnight: quinzena
Fortunatelly: felizmente
Fortune: sorte, fortuna
Forward: para diante, para frente
Foster: adotivo
Foster-brother: irmão de criação
Foster-father: pai adotivo
Foster-son: filho adotivo
Foul: imundo
Found out: descobriu
Found: fundar; encontrado
Fourfold: quádruplo
Four-footed: quadrúpede
Foxy as well: muito atraente
Frame: moldura; formar, articular
Frankly: francamente
Fraud: fraude
Fraudulent: fraudulento
Freckless: sardinha (pigmento na pele)
Freeway: autoestrada
Frequently: frequentemente, muitas vezes
Fresh: fresco
Friar: frade
Fridge: geladeira
Friendly: amigável
Friendship: amizade
Frighten: assustar
Fringe: franja, margem
From cover to cover: da primeira à última página
From head to foot: da cabeça aos pés 
From miles away: a milhas de distância
From now on: doravante, de agora em diante
From that time on: daquele momento em diante
From time to time: de tempos em tempos
From top to toe: da cabeça aos pés 
Front desk: recepção
Front door: porta da frente
Front Yard: jardim da frente
Frontier: fronteira
Frost: gelo, geada, congelado
Frozen: congelado
Frozer: congelador
Fry: fritar
Frying pan: frigideira (frigideira rasa para fritar)
Fudge: lorota
Fuel gauge: mostrador de gasolina
Fuel pump: bomba de combustível
Fulfill: preencher
Fulfilling: gratificante
Full name: nome completo
Full stop (UK): ponto final 
Full time: horário integral
Fuller: mais pleno
Fully: complemento
Fun: graça, diversão
Fund: fundo (recurso financeiro)
Funny: engraçado
Fur: pelo (animal)
Furnish: mobilar, fornecer
Furniture: mobília
Further: mais distante
Furthermore: além disso, além do mais, ademais
Fuselage: fuselagem
Fuss: pertubar
Gabardine: gabardine (tecido robusto para terno, blazers, jaleco, jaquetas, paletó, colete...)
Gaffer: velho, capataz
Gain: ganhar
Gallantly: belamente
Gallon: galão
Gamble: apostar
Gambler: jogador
Gammer: velha, velhota, tiazinha
Gander: ganso
Garage: oficina, garagem
Garlic press: espremedor de alho
Garlic: alho
Garment bag: porta-terno, porta-vestido
Garment: indumentária
Gas tank: tanque de gasolina
Gas: gasolina, combustível
Gate: portão
Gather round: reunir-se, juntar-se à volta de
Gather: unir, juntar, reunir, jantar
Gay: alegre
Gear shift: câmbio, caixa de marcha
Gear: marcha
Gee!: nossa!, xi, credo, puxa!, arre!
Geese: gansos
General: geral
Generate: gerar
Genii: gênios (espíritos)
Get a chance: ter uma oportunidade
Get a cramp: dar uma cãibra
Get a flat tire: furar o pneu
Get a haircut: cortar o cabelo
Get a life: procurar algo para fazer
Get across: comunicar, esclarecer, convencer
Get ahead: progredir, ir adiante, chegar a frente
Get along (with): lidar, conviver, se dar bem, dar-se, relacionar-se com
Get around: viajar, evitar
Get at: criticar 
Get away: fugir, escapar; ir-se embora
Get back from: retornar de
Get back: voltar, retirar-se, retornar
Get behind: ficar atrás, contrair dívidas
Get better: melhorar
Get bogged down: atolar-se
Get burned: queimar-se
Get busy: ocupar-se
Get by: sair-se, virar-se, sobreviver
Get credit for: receber crédito por
Get down to: começar, dar início
Get down: descer
Get dressed: vestir
Get engaged to: ficar noivo, comprometer-se
Get even with: ir à forra
Get even: acertar contas, ficar quites, vingar-se, empatar
Get fit: to get in shape: ficar em formar
Get hold of someone: entrar em contato
Get home: chegar em casa
Get hungry: ficar com fome
Get in a sweat: ficar nervosa
Get in shape: ficar em forma
Get in touch: entrar em contato
Get in trouble: se meter em confusão, dar-se mal
Get in: entrar num lugar ou carro; vencer (eleição)
Get into: entrar, envolver-se com
Get it clean: limpá-lo
Get it off my chest: desabafar, tirar um peso das costas
Get lost: desapareça, perder-se
Get married to: casar com
Get money: conseguir minheiro
Get off the subject: fugir do assunto
Get off: descer (de veículo); levantar voo (avião); ser absolvido; fugir, partir, retirar, descer, sair
Get old: envelhecer
Get on: subir, prosperar; passar, ir (de saúde), entrar num veículo, embarcar (veículo coletivo)
Get out of the car: saia do carro (em cima do carro)
Get out of the rut: sair da rotina
Get out: sair, fugir, ir-se embora, retire-se, partir
Get over: refazer-se, superar, recuperar-se de uma doença, resignar-se, curar-se, superar
Get paid: ser pago, receber
Get past: passar a outra parte
Get ready: aprontar-se, preparar-se
Get revenge: vingar-se
Get rid of: livrar-se de
Get some good time: nos divertir
Get somebody down: deprimir alguém
Get something back: reaver algo
Get something off: remover algo
Get something under way: pôr a caminho, pôr em execução
Get stuck: prender-se, ficar preso
Get the hopes up too high: esperar demais, falsas esperanças
Get the queerest ideas: ter ideias mais sombrias
Get through: sobreviver, ultrapassar, terminar 
Get to know: conhecer
Get to someone: afetar ou irritar alguém
Get to: chegar a
Get together (with): reunir-se com
Get tough: ficar difícil
Get up (quando deitado, após acordar): levantar-se
Get upset: chatear-se
Get: chegar, tornar-se, ficar, receber, ganhar, arranjar, conseguir, comprar, trazer, pegar (contrair), ter (have got), ter que (have got - obrigação), ser (auxiliando a voz passiva), convencer, persuadir, ir, entender, alcançar
Getting ahead in life: subindo na vida
Getting better and better: ficando cada vez melhor
Gild: dourar
Ginger hair: cabelo ruivo
Gird: cingir
Girder: viga
Give a dime: importar-se com, nem aí
Give away: doar, dar, distribuir, desperdiçar
Give back: devolver
Give birth: dar a luz
Give in: render-se, desistir
Give offence: offender
Give out: esgotar-se, exaurir-se
Give someone the lie: desmentir
Give up: desistir, render-se, abandonar, entregar 
Give way: dar lugar
Glad to meet you: muito prazer
Gladsome: contente
Glance: relance, passou os olhos
Glare: luz, clarão
Glasses: vidros, copos, lentes, óculos
Gleam: clarão
Gleaming: brilho
Glitter: brilho, brilhar
Globe: globo
Gloom: escuridão
Glove compartment: porta luvas
Go (well) with: combinar
Go about: lidar com
Go ahead: vá adiante, progressista; prosseguir, avançar, continuar
Go away: vá embora, ir embora
Go back: voltar (para lá), retroceder, regressar
Go bad: estragar
Go by: passar
Go down: descer, vá para baixo, siga o fluxo contrário dos carros, pôr-se 
Go for it: segue em frente, vai fundo
Go get it: vá buscar
Go hard: ir com tudo, pegar pesado
Go in: entrar, vá para dentro
Go jogging: correr, fazer cooper
Go off: disparar (arma); partir
Go on a strike: entrar em greve
Go on: prosseguir, continuar
Go out: sair, vá para fora
Go over: atravessar, transpor (campo, rio, rua, mar); examinar
Go round: girar, ser sufiente
Go shopping: ir às compras, ir fazer compras
Go short of: ficar com pouco
Go straight ahead: vá direto em frente
Go straight: ir direto
Go swimming: ir nadar
Go to one's head: subir à cabeça
Go to the shopping: ir ao shopping
Go under: fracassar, arruinar-se
Go up: siga o fluxo dos carros, subir, vá para cima, desaparecer
Go with: combinar com
Goal: objetivo
Goat: cabra 
Goatee: cavanhaque
God damn it: maldição
Goddess: deusa
Godfather: padrinho
Godness: bondade
Going the right way: fazendo as coisas certas
Good gracious: nossa
Good old times: bons e velhos tempos
Good-for-nothing: pessoa sem valor
Goodly: atraente
Good-natured: boa índole
Goodness: bondade
Goods: mercadorias
Goody: bonzinho (ironicamente)
Goose: gansa, ganso
Gorgeous: maravilhosa
Gorilla: gorila
Gosh: caramba
Gossipy: tagarela
Got all messed up: confundiu-se todo
Got me wrong: me entendeu errado
Got sit down: sentar-se 
Got stuck: ficamos preso
Got up: levantou
Got: conseguiu
Gout: bode, gota
Govern: governar, governo
Governess: governanta
Government: governo, autonomia
Grab: pegar, agarrar
Grade: grau, categoria, classe, nota
Gradson: neto
Graduated: diplomado, formado, graduado
Grain: grão
Grammar: gramática
Grand daughter: neta
Grandchildren: neta ou neto (granddaughter + grandson)
Grandma: avó
Grandpa: avô
Grandparents: avó ou avô (grandmother + grandfather)
Grant: conceder
Grapefruit: toranja
Grapevine: vinha
Grassy: cheio de grama
Grate: ralar
Grateful: grato, agradecido
Grater: ralador
Gratifying: gratificante
Grave stone: lápide
Grave: túmulo (subst.); gravar (verb.), cova
Gray: cinza, cinzento
Grayish: acinzentado
Grease: gordura
Great: excelente, excepcional, grandioso, grande
Greatness: grandeza
Great-uncle: tio-avô
Greek: grego
Green beans: vagem
Green onion: cebolinha
Green pepper: pimentão
Greenish: esverdeado
Greet: cumprimentar, saudar
Grew up: cresceu
Grey: cinza, cinzento
Grief: desgosto, dor, pesar
Grill pan: panela de grelha (frigideira)
Grill: grelha, grelhar
Griller: churrasqueira
Grind: moer, afiar, triturar, esmagar
Grippe: gripe
Grocer: verdureiro
Groin: virilha
Groom: noivo
Ground beef: carne moída
Ground floor: térreo
Ground: moído, chão, castigar
Grounds: terreno ao redor de uma casa, terrenos, parques; razões, fundamentos; sedimento
Group talk at the table: conversa a mesa
Grouse: galo silvestre
Grouth: crescimento
Grow big: ficar maior
Grow old: envelhecer
Grow older: envelhecer 
Grow Strong: ficar mais forte
Grow thinner: emagrecer 
Grow wise: ficar mais sábio
Grower: plantador
Grown-up: adulto
Guarantee: garantir
Guardsman: guarda
Guava: goiaba
Guess what: adivinhe
Guess: adivinhar
Guest: hóspede
Guidance: orientação, aconselhamento
Gum: gengiva, goma, chiclete
Gunfight: tiroteio
Gunpolder: pólvora
Guts: tripas
Gutter: sarjeta
Guys: cara (serve para ambos os sexos - grupo)
Habit: hábito
Had a hard time: passou mal bocado
Hail: saudar, prestar reverência
Hair conditioner: condicionador
Hairdresser: cabeleireira
Hairy: peludo
Half (a buck): 50 centavos
Half a dozen: meia dúzia
Half an hour: meia hora
Half way: meio do caminho
Hall: corredor, salão, sala
Ham: presunto
Hamburguer bread: hambúrguer
Hammock: rede
Hand and hand: de mãos dadas
Hand in: entregar 
Hand out: distribuir; folheto, panfleto 
Hand writing: caligrafia
Hand: mão, entregar (em mãos), passar
Handbag: pasta, mala, bolsa
Handbrake: freio de mão
Handful: punhado
Handicap: prejudicar, dificultar
Handkerchief: lenço
Handle: manusear, lidar com, tratar, maçaneta
Handwritings: caligrafia
Hang: pendurar, enforcar
Hanger: cabide
Hangover: ressaca
Happen: acontecer (ao acaso), ocorrer
Happy-go-lucky youngsters: jovens despreocupados
Harbour: porto
Hard time: dificuldade
Hard: com força, duro 
Hardly ever: raramente, dificilmente
Hare: lebre
Hark: escutar, ouvir 
Harm: dano
Harmfull: prejudicial
Harmless: inofensiso
Harmonize: harmonizar
Hart: cervo
Harvest: colheita
Has just arrived: acabou de chegar
Has just taken place: acaba de acontecer
Haste: pressa
Hatch: chocar; escotilha
Haughty: arrogante
Have a good head for figures: ser bom com números
Have a good time: divertir-se
Have a haircut: cortar o cabelo
Have a look: dar uma olhada
Have a turn for: ter inclinação para, ter queda para
Have done: basta
Have fun: divertir-se
Have nothing to do with...: não ter nada haver com...
Have parties: organizar festas
Have the intention of: pretender
Have your hair done: arrumar o cabelo
Have: comer, beber, tomar (substitui - eat, drink)
Havoc: caos, dano
Hawk: falcão
Haystack: palheiro
Hazard light: pisca alerta
Hazardous: arriscado
Hazel nut: castanha do Pará
Hazel: cor de mel, avelã
He looks like: parece-se com
He was meant: ele deveria
Head over heels: de pernas para o ar, de cabeça para baixo
Head: cabeça; dirigir; chefe, tomar o rumo
Heading: cabeçalho
Headlamp: farol
Headlights: farol
Headmaster: diretor
Headrest: encosto de cabeça
Heads back: ir em direção
Healing: cura
Healthy: sadio
Heap: pilha, montão, monte; amontoar
Heaps of: montes de, um grande número de, grande quantidade 
Hear: ouvir
Hearken: escutar, dar atenção a
Heart attack: infarto
He-ass: jumento
Heave: içar, dar, soltar
Heed: cuidado, atenção
Heel: calcanhar
He-goat: bode
Heir: herdeiro
Heiress: herdeira
Hell of a: inferno
Helluva: inferno
Help yourself: se vira, sirva-se
Helpful: útil
Hen: galinha
Hence: daqui, daí, por isso
Herb: erva
Here you are: aqui está
Here you go: aqui está
Here it is: aqui está
Hereafter: doravante
Hereby: por este meio, pelo presente, por estas palavras
Hereof: a este respeito 
Hereon: a este respeito
Heritage: herança, patrimônio
Heroin: heroína (droga)
Heroine: heroína
Hew: cortar, talhar
Hicup: soluço
High heels: salto alto
High school: escola secundária
Highway: autoestrada, rodovia
Hijacker: sequestrador (meio de transporte)
Hiking trip: caminhada (mochileiro)
Hill: colina
Hillock: colina
Hind: serva; posterior, traseiro
Hipster: hippie
Hire: alugar, aluguel, contratar
Hireling: mercenário
Hire-purchase: compra a prestações
Hit on: paquerar, descobrir por acaso, dar em cima 
Hit the road: pegar estrada
Hit: bater, acertar
Hither: para cá
Hoarse: rouco
Hobby: passatempo
Hog: porco
Hoity-toity: brincalhão
Hold it: esperar
Hold on: aguentar
Hold: segurar, aguentar, abraçar (envolver - música)
Holland: Holanda 
Hollow: oco
Homeland: terra natal
Homelike: confortável
Homemade: caseiro
Hometown: cidade natal
Homeward: de regresso (viagem)
Homework: tarefa de casa, lição de casa
Honest: honesto
Honeymoon: lua de mel
Honor: honra
Hood: capuz, capô (carro)
Hoof: casco (de animal)
Hook: gancho
Hooping cough: coqueluche
Hop: pular
Hope for: almejar, desejar
Hopeful: esperançoso
Hopeless: desesperançado, desanimado; incurável
Horn: chifre
Horse: cavalo; cavalaria; soldados da cavalaria
Hose: mangueira
Host: anfitrião, recepcionar
Hostel: albergue
Hot dog bread: cachorro quente
House work: tarefa de casa (limpar, lavar...)
Housekeeper: governanta
Housewife: dona de casa
Housing: moradia
How about you: e você?
How about: que tal? 
How are things with you: como estão as coisas com você?, como vai você?
How are things: como estão as coisas?
How are things: como vai você?
How are you doing: como vai você?
How are you: como vai você?
How big: qual tamanho
How come: como assim, como (de que forma), como, de que forma
How did you like it?: o que você achou?
How do you like?: o quanto você gosta?, o que você acha?
How far: a que distância
How kind of you: é muita gentileza de sua parte
How large is it?: qual o tamanho?
How long is it?: qual o comprimento?
How long?: por quanto tempo?
How often: com qual frequência
How was it?: como foi? 
How wide is it?: qual a largura?
How's life treating you: como vai você?
However: no entanto, contudo, todavia, entretanto, porém, mas
Howl: uivar
Hug (emotivo): abrassar
Huge: enorme
Humane: humana
Humanitarian: humanitária
Humble: humilde
Humbug: farsa
Humility: humildade
Hummingbird: beija flor
Hunting trip: caçada
Hurry up: apressar-se
Hurry: depressa, apressar-se
Hurtle: chocar-se, arremessar-se, entrechocar-se
Hush (subst.): silêncio
Hussy: sirigaita
Hut: cabana
Hydroplane: hidroavião, hidroplano
Hyphen: hífen
Hypotheses: hipóteses
Hypothesis: hipótese
Agree with: concordar com você
I am in the mood: eu estou a fim de
I am pretty sure: eu tenho muita certeza
I am very glad: tenho muita satisfação
I call the shots here: eu dou as regras
I can't help: eu não posso evitar
I can't stand: eu não suporto
I can't afford: eu não posso aguentar (eu não consigo pagar...)
I can't bear: não suporto
I do the cooking: eu cozinho
I feel like: eu sinto como se, estou a fim
I got it: eu entendi, estou ligado, eu saquei
I got my notes mixed up: eu baguncei, eu misturei minhas anotações
I gotta: ter de
I guess: eu acho
I had rather: preferiria 
Have a bath: tomar banho (imersão - banheira)
Have a shower: tomar banho (chuveirada)
Have got to: ter de
I have the guts: eu tenho estômago para isso
I live on the edge: eu vivo no limite
I make the rules: eu dou as regras
I mean it: é sério
I see: eu entendo, eu vejo
I shoudn't be thinking: eu não posso deixar de pensar
I sometimes: por vezes, às vezes
I suck at: eu sou horrível em
I sure do: certamente
I surely do: certamente
Take a bath: tomar banho (imersão - banheira)
Take a shower: tomar banho (chuveirada)
I think I will pass that one: eu acho que eu passo essa
I will call you: eu te ligo
I will keep an eye on you: vou ficar de olho em você
I will pay you a visit: vou te fazer uma visita
I will rain your parade: e se der tudo errado
I will telephone you: eu te ligo
I would rather: preferiria 
I would sooner: preferiria
I wouldn't even look for it: nem mesmo procuraria por isso
I'd better: é melhor eu
I'm afraid I am not: eu temo que não
I'm dare you: te desafio
I'm fed up with you: estou sem paciência com você
I'm fed up: eu estou alimentado
I'm so sorry: sinto muitíssimo
I'm sorry: sinto muito, desculpa
I'm with you: concordo com você
I've laid my guns down: eu baixei minhas armas
I've never heard about it: eu nunca ouvi falar a respeito
Ice cream scoop: colher de sorvete
I'd love: eu adoraria
Identical: idêntico
Identifiable: identificável
If we happen to go: se por acaso formos
If you prefer so: se você assim desejar
Ignorent: ignorante
I'll be out: eu estarei fora
Ill: doente, mau
Illegible: ilegível
Illnes: doença
Illustrate: ilustrar
I'm used: eu estou acostumado
Imaginative: imaginativo
Imbalance: desequilíbrio
Imitate: imitar
Immediate: imediato
Immediately: imediatamente
Immigrate: imigrar
Immune: imune
Impatient: impaciente
Impenetrable: impenetrável
Importance: importância
Impose: obrigar, impor
Impression: impressão
Improbable: improvável
Improve: melhorar, progredir
Improvement: progresso
In a bad shape: em mau estado
In a good shape: em bom estado
In a hurry: com pressa
In a short time: dentro de pouco tempo
In a stew: em apuros
In a way: de uma certa maneira, de uma certa forma
In a while: em um instante
In addition to: além de
In advance: adiantado
In after years: em anos vindouros
In average: em média
In back of: atrás de
In behalf of: em favor de, no interesse de, para bem de
In black: de preto
In bulk: a granel
In charge of: encarregado de, a cargo de
In charge: no comando
In cold blood: a sangue frio
In fact: de fato
In front of: em frente (uma passagem entre as duas coisas) (oposto de behind)
In full: por extenso
In good repair: em bom estado 
In horror: apavorado
In keeping with: em harmonia com, em conformidade com
In no case: em hipótese alguma
In no time: em pouco tempo, sem demora
In order that (finalidade, propósito): a fim de que, para que, de modo que, de maneira que
In order to: a fim de (indica propósito), para
In settlement of account: para liquidar a conta, como pagamento do saldo devido
In shape: em forma
In short: em resumo
In spite of: apesar de + (verbo + ing: infinitivo)
In sum: em suma
In the afternoon: à tarde
In the daytime: de dia
In the end: até que enfim, finalmente
In the evening: à noite
In the late forties: nos últimos 40 anos
In the meantime: enquanto isso
In the open: ao ar livre
In the role of: na qualidade de, como
In the same way: da mesma maneira, como
In the way: no caminho
In time: a tempo
In trouble: com problemas
In: em (dentro)
Inaccessible: inacessível
Incidence: incidência
Incident: incidente
Include: incluir
Including: inclusive
Inclusive: inclusive
Income support: auxílio remunerado
Income: renda, rendimento
Inconsiderate: imprudente, inconsiderado
Inconsistent: inconsistente
Incorrect: errado
Increase: aumento, aumentar
Incredible: inacreditável
Indeed: sem dúvida, de fato, realmente, na verdade, certamente
Indefinite: indefinido
Indelible: indelével
Index: índice, índex
Indicate: indicar
Indices: índices (em matemática)
Indignant: indignado
Indispensable: indispensável, imprescindível
Indoor: local fechado
Indubitbly: indubitavelmente
Induce: induzir
Inexpensive: barato
Infantry: infantaria
Inflation: inflação
Influence: influenciar, influência
Info service: serviço de informação
Inform: informar
Infringement: infrigência
Ingenious: engenhosa, inventiva
Ingenuous: igênuo
Ingratiate oneself (with): ganhar as boas graças (de)
Ingratiate: agradecimento
Ingredient: ingrediente
Inhabitant: habitante
Inheritance: herança
Inheritor: herdeiro
Injure: ferir, machucar, causar dano
Injury: dano, ferimento
Ink: tinta
Inn: estalagem, pousada, hotel
Inner: interior, interno
Innovation: inovação
Inquire: informar-se, perguntar
Inseparable: inseparável
Inside out: do avesso
Inside: dentro
Insist: insistir
Inspired: inspirado
Install: instalar
Instead of: ao invés de + (verbo + ing: infinitivo), em lugar de, em vez de
Instruct: instruir
Insurance: seguro
Integrate: integrar
Intellectual: intelectual
Intend: pretender 
Interact: interagir
Interest: interessar
Interesting: interessante
Interior: interior
Intern: estagiário
Interpreter: intérprete
Interrogate: interrogar
Interval: intervalo
Interviewee: entrevistado
Intestins: intestinos
Intimate: íntimo
Into: para dentro (movimento)
Intolerable: intolerável
Intransitive: intransitivo
Intriguing: intrigante
Introduce: introduzir
Invade: invadir
Inverted commas: aspas 
Invest: investir
Investigate: investigar
Investigator: investigador
Invitation: convite
Invoice: fatura
Involve: envolver
Inward(s): para dentro
Irresponsible: irresponsável
Is out of: está sem
Is over: está acabado
Is that it?: é isso mesmo
Is that right?: é isso mesmo
Issue: problema (situação), edição, questão, emitir, publicar, promulgar
Istallments: prestações
It is (Tis - abreviação arcaica): isso é
It is good for nothing: não presta para nada
It is mouth watering: é de dar água na boca
It seems to me: me parece
It takes time: leva tempo
It's a pleasure to meet you: muito prazer
It's my way or the highway: é do meu jeito ou não
It's up to you: você que sabe, você quem manda, depende de você
Item: item
Itemize: relacionar, discriminar, enumerar
It's none of your business - não é de sua conta
Jack: macaco
Jack-ass: jumento 
Jackfruit: jaca
Jargon: jargão
Jeans pants: calça jeans
Jeer: zombar, ridicularizar
Jeopardize: prejudicar
Jet lagged: sonolento (fuso horário)
Jewess: judia
Jiffy: instante
John doe: zé ninguém
Join in: tomar parte em
Joke: piada, pilhéria
Jostle: empurrar, acotovelar(-se)
Jot down: anotar
Jot in down: tomar nota, anotar
Journey: jornada, viagem
Joust: lutar (em torneio)
Judge: julgar, juiz
Juicer: máquina de suco (espremedor)
Juicy: suculento
Jurisdiction: jurisdição
Just across: do outro lado
Just after: logo após
Just because: porque sim, não te interessa
Just do it: vai lá e faz, apenas faça
Just now: agora mesmo
Just the same: mesmo assim
Just: imediatamente, bem, simplesmente, somente, acabei de, justa
Justifiable: justificável
Karats: quilates
Keen: desejoso, interessado
Keep it up: continue
Keep off: manter longe
Keep on going: continuar indo
Keep on: continuar
Keep one's head: ficar calmo
Keep the change: fique com o troco
Keep up: continuar, acompanhar
Keep: manter, guardar, conservar
Kennel: canil
Kettle: chaleira
Key chain: chaveiro
Keynote speaker: orador principal
Kick off: começar
Kidnapper: sequestrador
Kidneys: rins
Killing time: passar o tempo
Kilo: quilo
Kin: parente
Kind of: tipo, meio
Kind: tipo (suj.), amável (adj.), bondoso
Kinda: tipo, meio
Kind-hearted: bondoso
Kinky hair: cabelo pixaim
Kinky: excêntrico
Kissed me goodbye: deu um beijo e disse tchau
Kit: mochila
Kitchenette: pequena copa-cozinha
Kitchenware: utensílios de cozinha
Kith and Kin: amigos e parentes
Kith: amigos
Kitten: filhote de gato, gatinho
Knee: joelho
Kneel: ajoelhar-se
Knickers: calções
Knit: tricotar
Knock: pancada
Knocked over: jogado ao chão
Knocking at the door: bater à porta
Knocking on the door: bater à porta
Knot: laço
Knuckles: juntas
Koran: alcorão
Labor: trabalho
Lack of: falta de
Lack: falta
Lackey: lacaio
Lad: rapaz
Ladder: escada
Lade: carregar, canal
Ladle: concha (cozinha)
Laid off: demitido
Lame: manco, aleijar
Lament: lamentar
Lamp: lâmpada, abajur
Land: pousar
Landlady: senhoria
Landlord: senhorio
Landscape: paisagem
Landslide: deslizamento de terra
Lane: faixa (estrada, rua)
Lap: colo, volta
Lasagna: lasanha
Lass: moça
Last name: sobrenome
Late: atrasado, tarde, tardio, finado, falecido
Latest: mais recente
Laugh at: rir-se de (alguém), rir-se devido a um fato
Laugh out loud (LOL): sorrir em voz alta
Laundromat: lavanderia (fora do domicílio)
Laundry room: lavanderia (cômodo)
Laundry: roupa suja, lavanderia
Laureate: laureado
Law office: escritório de advocacia
Law school: faculdade de direito
Lawyer: advogado
Lay down: deitar, botar ovos
Lay: deitar, por (sentido de botar ovos), colocar
Lazy: preguiçoso
Lead: conduzir, liderar, guiar, dirigir, chumbo
Leaf: folha
Leaking: vazando
Lean: reclinar-se
Leap: pular, soltar
Learned: instruído, culto
Leather: couro
Leave out: excluir, omitir 
Leave us back at: nos deixar
Leaves: folhas
Lecture: conferência, palestra, discursar
Left: esquerda, saiu, partiu, deixou
Left-hand: à esquerda
Leftover: sobra (comida)
Legible: legível
Legth: comprimento
Lemon: limão (amarelo)
Lend: emprestar
Lengthwise: ao comprido
Lent: Quaresma
Lesser: menor
Lest: do contrário, para que não
Let down: disapontar 
Let it be: deixe que seja (m)
Let's get down to business: vamos ao que importa
Let's make arrangements: vamos combinar
Let's: let us (arcaico): vamos 
Lettuce: alface
Level: nível
Levied: cobrado
Liability insurance: seguro contra terceiros
Liberal: liberal
Library: biblioteca
Lice: piolhos
License plate: placa (automóvel)
Lid: tampa
Lie down: deitar-se
Lief: de bom grado
Lieutenant: tenente
Life insurance: seguro de vida
Life-bealt: salva-vidas
Lifeboat: barco salva-vidas
Lifeguard: guarda de segurança, salva-vidas
Lift off: decolar (sentido de decolar na vertical - caças)
Lift weight: malhar, fazer exercício, levantar peso
Lift: elevador, levantar, erguer
Light bulb: lâmpada
Light: iluminar, lâmpada, foco de luz; luz, luminosidade; leve
Lighting: iluminação
Lightning: raio (o que é visto)
Like this: assim (dessa maneira)
Likelihood: probabilidade
Likely: provável
Likewise (adição): além disso, além do mais, igualmente, da mesma forma, também, outrossim
Limb: membro, galho
Lime press: espremedor de limão
Lime: limão (verde), lima
Lined up: enfileirados
Linen: linho
Lioness: leoa
Listen to (verbo preposicionado): escutar
Listen: escutar (ouvir com atenção)
Literature: literatura
Livable: habitável
Lively: vivo, vibrante, animado
Liver: fígado
Living area: área livre
Living standards: padrões de vida
Lo and Behold: vejam só
Load off: aliviar
Lobby: saguão
Lobster: lagosta
Located: localizado
Locked: fechado à chave
Locker: armário
Lodge: alojamento; apresentar, alojar
Lodging: acomodação
Log: tronco, lenha, tora
Logical: lógica
Long Holiday: feriado prolongado
Long may: por muito tempo
Long time on see: quanto tempo!
Look (at) what the cat dragged in: olha o que apareceu
Look after: procurar; cuidar de
Look ahead: planejar o futuro
Look alike: ser parecido
Look around: olhar ao redor, conhecer um local
Look as if butter wouldn't melt in (one's) mouth: parece que a manteiga não derreteria em sua boca
Look askance: olhar desconfiado, inveja, desconfiança, olhar com maus olhos
Look at the cat that ate the canary: parecer muito feliz, tentar esconder algo
Look at: olhar para (examinar)
Look away: desviar o olhar
Look back on: pensar sobre algo do passado
Look back: olhar para trás
Look before you leap: olhar antes de dar o próximo passo
Look daggers at someone: olhar fulminante
Look down on: julgar alguém inferior, achar que é melhor que os outros
Look for: procurar
Look forward to: esperar ansioso
Look in on: fazer uma visita a alguém
Look into: investigar (olhar atencioso, estudar), procurar
Look like a candidate for a pair of wings: parece-se a um candidato a um par de asas
Look like a drowned rat: molhado da chuva
Look like a million: parecer fantástico
Look like a saddle on a sow: não combina muito/ pouco para você
Look like death warmed over: parecer ou sentir-se muito mal
Look like through somebody: ignorar
Look like: parece que, parecer
Look on someone or something: considerar algo ou alguém de uma forma específica
Look on the sunny side (of life/ things): ver o lado bom da vida/ coisa
Look on: ser espectador, assistir
Look out for (trouble): procurar (aborrecimentos, complicações)
Look out for someone: proteger alguém
Look out: cuidado, tome cuidado
Look over: olhar por cima de; examinar; perdoar (falta), revisar algo com velocidade
Look peaked: parecer doente
Look round: olhar ao redor, conhecer um local
Look sideways at: olhar com segundas intenções, fitar
Look somebody in the eye/ eyes: olhar nos olhos
Look someone up: procurar alguém
Look something up: procurar alguma informação (lista ou páginas)
Look the other way: olhar para o outro lado, ignorar algo
Look through a millstone: percepção apurada
Look through blue glasses: olhar com desconfiança
Look through: dar uma analisada rápida
Look to: contar com a ajuda
Look toward: olhar em direção
Look up and down for: procurar por toda a parte
Look up on someone: olhar com respeito, admiração
Look up to: admirar muito; procurar
Look up: procurar
Look upon someone or something: considerar algo ou alguém de uma forma específica
Look who's talking: olha quem está falando
Looking in: observando
Looking over one's shoulder: ficar atento, preocupado
Loose: alargar, afrouxar, solto, frouxo
Loot: saque
Lord justice: juiz do supremo tribunal
Lose one's head: perder a cabeça, o controle
Lose weight: emagrecer
Lose: perder (sentido de não encontrado)
Loss: perda, prejuízo
Lot: grande quantidade, montão, muito
Lots of: muito (a), muitos (as) ? contáveis/ incontáveis; monte, um grande número de
Lottery: loteria
Loud: agudo, alto (referido a sons)
Louse: piolho
Love seat: sofá para duas pessoas
Lovely: amada
Lower: mais baixo, diminuir, baixar
Loyal: leal, firme
Luggage cart: carrinho de bagagem
Luggage: bagagem
Lung: pulmão
Machinery: maquinaria
Mackerel: cavala
Mad: louco
Madam: senhora
Madame: senhora
Made it up: reconciliaram, inventaram
Madman: louco
Madness: loucura
Magazine: revista
Magneto: magneto
Magnificent: magnífico, sumptuoso
Maid: criada, empregada doméstica, solteira, donzela
Maiden: solteira
Mail: enviar via correio, correio
Main course: main dish: prato principal
Main: principal
Maintenance: manutenção
Make a bad impression (on): causar má impressão
Make a date (with): appointment: marcar um encontro
Make a decision (about): decidir, tomar uma decisão
Make a down payment: dar de entrada, dar um sinal
Make a face (at): fazer careta
Make a fool of someone: fazer alguém de bobo
Make a fuss: exaltar-se, fazer rebuliço, fazer estardalhaço
Make a good impression (on): causar boa impressão
Make a lany no difference: fazer diferença
Make a living: ganhar a vida
Make a phone call (to): telefonar, dar um telefonema
Make a point: fazer uma observação, apresentar um ponto de vista
Make a profit: lucrar, ter lucro
Make a reservation (for): fazer uma reserva
Make a resolution: fazer uma promessa, tomar uma decisão importante
Make a speech (to): fazer um discurso
Make after: ir ao alcande de
Make an investment: investir, fazer um investimento
Make at: atacar
Make believe: fazer de conta
Make breakfast: preparar o café da manhã
Make ends meet: trabalhar para pagar as contas
Make friends (with): fazer amizade
Make fun of: ridicularizar
Make it again: faça de novo
Make it clear: deixar claro
Make it to: checar, conseguir
Make laws: elaborar leis
Make mistakes: cometer erros
Make Money: ganhar dinheiro
Make na excuse (for): arranjar uma desculpa
Make out: fingir; calcular, presumir; decifrar
Make Peace: fazes as pazes
Make progress (in): progredir
Make sense (to): fazer sentido
Make someone happy: deixar feliz
Make someone look ridiculous: parecer ridículo, envergonhar
Make sure (about): certificar-se
Make sure: ter certeza, certificar-se
Make the bed: fazer a cama
Make the most of (something): aproveitar ao máximo
Make trouble: criar problemas ou confusão
Make up your mind: decidir-se, tomar uma decisão (your acompanha o sujeito)
Make up: maquiagem, maquilar-se; completar; inventar, forjar, compor
Make use of: use: utilizar
Make war: guerrear, entrar em guerra
Make way: abrir caminho, dar passagem, progredir
Make yourself at home: sinta-se à vontade
Make: fazer (criado do zero, construído)
Malfunction: mal funcionamento
Mall: shopping center
Malleable: maleável
Man servant: criado
Manage: dirigir, administrar
Management: administração
Manager: empresário, gerente
Mane: juba
Manful: ousado, resoluto, decidido
Manger: manjedoura
Mango: manga
Manifold: múltiplo, multíplice
Manipulation: manipulação
Mankind: humanidade
Manlike: másculo, varonil, próprio de homem
Manly: viril, valente; nobre
Manner: maneira, modo
Manners: hábitos, costumes; comportamento social
Mantel: cornija da lareira
Many a: muitos
Many: muitos, um grande número de 
Mar: estragar
Marble: bola de gude
March: marchar, março
Marchioness: marquesa
Mare: égua
Mark: marca
Marker: marcador para quadro
Marks of omission: reticências 
Marquess: marquês
Marquis: marquês 
Marquise: marquesa 
Marriage: casamento
Marry: casar-se
Martyr: Mártir
Marvelous: maravilhoso
Mashed: purê
Masked: mascarado
Masquerade ball: baile de mascara
Mass: missa, massa
Massacre: massacre
Master bedroom: quarto principal
Masterpiece: obra-prima
Mat: esteira, tapete
Match: combinar (harmonizar), corresponder; fósforo; partida, jogo
Mate: parceiro, amigo, colega
Materialism: materialismo
Math: matemática
Mathmatics: matemática
Matter: matéria, assunto (sentido vago), questão; importar
Mattress: colchão
Meadow: campina
Meal: refeição
Mean that: quis dizer
Mean: significar, querer dizer, malvado, maldoso; média; médio
Meaning: significado
Means of transportation: meios de transporte
Meantime: enquanto isso, entretanto
Meanwhile: enquanto isso, entretanto, entrementes
Measles: sarampo
Measure tape: fita métrica
Measure: medir
Meat grinder: moedor de carne
Meat slicer: fatiador de carne
Meat tenderizer: amaciador de carne
Meat: carne
Mechanical pencil: lapiseira
Median strip: canteiro
Medical: médico (adjetivo)
Medicine cabinet: farmácia (armário)
Medicine: remédio, medicina
Mediterranean: mediterrâneo
Meet: carne
Meeting: encontro, reunião (negócios)
Member: sócio, membro
Membership: adesão, filiação, associação, associado
Memorandum: memorando
Memorize: memorizar
Mentioned: mencionado
Merchandise: mercadoria
Merchant: comerciante
Merely: meramente
Merry: alegre
Mess: bagunça
Messy: bagunceiro
Method: método
Metropolis: metrópole
Microwave: micro-ondas
Midday: meio-dia
Middle name: nome do meio
Middle: meado, meio, médio
Migraine: enxaqueca
Mill: moinho
Millionaire: milionário
Millstone: pedra de moer, pedra de moinho
Mimic: arremendar
Mincer: moedor de carne
Mind: importar-se
Mine: mina
Miner: minerador
Mineral: mineral
Mingle: misturar-se, socializar, associar-se
Mini bar: frigobar
Mini skirt: minissaia
Miniature: miniatura
Mining: mineração
Minister: ministro
Minor: menor
Minutes: minutos, minutas, memorandos, ata
Minx: sirigaita 
Misconduct: má conduta, conduta errônea
Mise: ratos
Misfit: desajuste
Misfortune: desgraça, infortúnio
Misinformed: mal informado
Misjudge: julgar mal
Misprints: erros (de impressão)
Mispronounced: mal pronunciado
Miss: perder (oportunidade), sentir falta, senhorita (solteira) (pronúncia mis)
Mist: névoa, neblina
Mistake: erro (substantivo - erro sem intenção)
Mistress: senhora, mestra, patroa, amante
Misunderstanding: engano, mal-entendido
Misunderstood me: me entendeu errado
Misured: mal utilizado
Mitt: luva (sem dedo)
Mitten: luvas (baseball)
Mix up: confundir, misturar, associar-se
Mix: misturar
Mixer: batedeira
Mlueberry: mirtilo
Moat: fosso
Mob: máfia
Mobster: mafioso
Mock: zombar, zombaria, simulado
Mold: mofo
Monarch: monarca
Monk: monge
Monosyllabic: monossilábico
Monsieur: senhor
Moor: amarrar, atracar; pântano
Morale: moral (confiança, otimismo ou domínio espiritual)
More and more: cada vez mais
Moreover: além do mais, além disso
Morn: manhã
Moron: idiota
Moss: musgo, limo
Most often: frequentemente, frequentissimamente, a maior parte de, a maioria
Most: a maioria
Mostly: pela maior parte, geralmente
Motel: hotel de estrada
Moth is watering: boca cheia d'água
Moth: mariposa
Mother language: língua materna
Mother tongue: língua materna
Motherhood: maternidade
Motion: moção, movimento
Motivate: motivar
Motorbike: moto
Motorcar: automóvel
Motorcycle: moto
Motto: lema
Mount: monte, montanha
Mourning: luto
Moustache: bigode
Mouthwash: enxaguante bucal
Move in: instalar-se
Move on: avançar
Move: mover, mover-se, se mudar
Movie theater: cinema
Movie: cinema
Movies: filme, cinema 
Moving: comovente
Mow: segar, ceifar
Mr: Mister: senhor (usado para solteiro e casado)
Mrs: senhora (casada) (abreviação de mistress) (pronúncia missis)
Ms: senhora (casada ou solteira) (pronúncia miz)
Much: muito, grande quantidade 
Mud: lama
Muff: regalo (agasalho)
Mug: caneca
Mulberry: amora (menores)
Multinational: multinacional
Multitude: multidão
Mumps: caxumba
Muscle car: carros antigos potentes
Musician: músico
Mutt: vira-lata
My bad: foi mal
My godness: meu Deus
My goodness: meu Deus
My on way: ao meu modo
Mysterious ways: formas misteriosas
Nail polish: esmalte
Nail: unha; pregar, prego
Namely: a saber
Nap: soneca
Nape: nuca
Napkin: guardanapo
Narrate: narrar
Narrative: narrativa
Narrow: estreito
Narrow-minded: mente fechada
Nasty: desagradável, asqueroso
Nationality: nacionalidade
Naught (EUA): zero (numeral), nada
Navel: umbigo
Navy blue: azul marinho
Navy: marinha
Near: perto
Nearby: por perto
Nearly: aproximadamente, quase
Near-sighted: míope
Neat: em ordem
Neatly: carinhosamente, atenciosamente
Neck and neck: emparelhados, empatados (em corrida)
Necklace: colar
Needed: necessário, requerido
Needle: agulha
Negligent: negligente
Neighborhood: vizinhança, bairro
Neither ... nor: nem... Nem
Neither: nem um nem outro, nem uma nem outra, nenhum dos dois, nenhuma das duas
Nephew: sobrinho
Nest: ninho
Net: rede
Netherlands: Holanda
Never ever: nunca mesmo (ever enfatiza never)
Never look a gift horse in the mouth: cavalo dado não se olham os dentes
Never mind: não tem importância, deixa para lá
Neverend: nunca acaba
Nevertheless: no entanto, porém, contudo, todavia, mesmo assim
New: novo (coisas)
Newspaper: jornal
Next to impossible: quase impossível
Next to nothing: quase nada
Next to: ao lado, próximo, perto
Nice to meet you: muito prazer
Nick: usuário
Niece: sobrinha
Night out: divertir, noitada
Night shift: turno da noite
Night stand: criado-mudo
Nightlife: vida noturna
Nil (subst.): nada; zero
Nipples: mamilos
No more: chega de
No way: sem chance, de maneira nenhuma, de jeito nenhum
Noble: nobre
Nod: balançar a cabeça (para cima e para baixo), acenar com a cabeça
Noisy: barulhento
None: nenhum 
Non-profit: sem fins lucrativos
Nonsense: absurdo, tolice, disparato, bobagem
Non-smoker (subst.): não fumante
Non-smoking (adj.): não fumante
Nonstop: sem escala
Non-violently: sem violência
Noon: midday: meio dia
Nor: não, nem
Norm: norma
Norse: nórdica
North: norte, setentrional 
Northern: do norte, setentrional
Northward: que vai para o norte, do norte
Nose door: porta da frente
Nose: nariz
Not at all: de forma alguma, absolutamente, de nada
Not bad: bem
Not even: nem mesmo, nem se quer
Not much to look at: nada de especial
Not much: nada demais
Not only... But also: não só... Mas também
Not really: na verdade não
Not that much: nem tanto assim
Not to: para não
Not yet: ainda não
Notebook: caderno de anotações
Notherly: que vem do norte (vento), situado no norte, que vai para o norte
Nothern: situado no norte, que vai para o norte (povo), que vem do norte (vento)
Nothing at all: de nada
Nothing special: nada de especial
Nothing: nada, zero (indica resultado no jogo ou no esporte)
Notice: perceber (visual), notar, observar, aviso, notificação, atenção, alerta, advertência
Notwithstanding: apesar de
Nought (UK): zero (numeral), nada 
Noun: substantivo, nome 
Nourishing: saudável, nutritivo
Novel: romance, novela
Now and again: de quando em quando, de vez em quando
Now and then: de quando em quando, de vez em quando, eventualmente
Now then: e então
Nowadays: em nossos dias, atualmente, hoje em dia, nos tempos modernos
Nowhere else: em mais nenhum lugar (em nenhum outro lugar)
Nudge: cutucar, acotovelar
Nuisance: incômodo
Null: nulo, zero
Numb: anestesiado, dormente, entorpecido
Numbers: números; versos
Nun: freira
Nupcials: núpcias
Nut: noz
Nutcracker: quebra nozes
Nuts: nozes, castanha, louco, porca (ferramenta)
O'clock: hora cheia - 00
Oak tree: carvalho
Oases: oásis
Oasis: oásis
Oat: aveia
Obedient: obediente
Obey: obedecer
Object to: fazer objeção a
Obligations: obrigações
Oblige: obrigar
Observe: observar
Obtain: obter
Occasion: ocasião
Occasionally: ocasionalmente, eventualmente, de quando em quando
Occur: ocorrer
Odd: estranho, fora de contexto, ímpar
Odds: chance, probabilidades
Of late: recentemente
Of yore: outrora
Off and on: de quando em quando, de vez em quando
Off: fora (contato) (oposto de on)
Offensive: ofensiva
Offer: oferecer, oferta
Office: escritório, cargo 
Official: oficial, funcionário
Oficial: funcionário
Often away: muitas vezes fora
Often: frequentemente, geralmente, muitas vezes
Oil pan: cárter
Oil: óleo, azeite 
Old: velho (coisas e pessoas)
Old-fashioned: antiquado
Oldness: velhice
Olive oil: azeite
Olive: azeitona
Omilette: omelete
Omit: omitir
On account of: devido a
On an average: em média
On behalf of: em nome de, da parte de
On foot: a pé
On my way: a caminho, no caminho
On sale: promoção, em promoção
On second thought: pensando melhor
On shore: em terra firme
On the contrary: pelo contrário
On the other hand: por outro lado
On the outside: ficar de for a, no lado de fora
On the rocks: com gelo
On the same vein: na mesma veia, na mesma linha de raciocínio, na mesma linha de pensamento
On the spur of the moment: no mesmo instante, de improvise
On the wait: na espera, a espera
On the way: a caminho
On their own: sozinhos
On time: a tempo, pontualmente
On: sobre (maior superfície de contato)
Once a: uma vez por
Once again: novamente, de novo, mais uma vez
Once every two months: uma vez a cada dois meses
Once in a while: de quando em quando, de vez em quando
Once upon a time: era uma vez
One is cold: sem sentimentos
One way or another: de um modo ou de outro
Oneway: mão única
Onion: cebola
Onto: em, para, sobre (contato)
Ooh: ui
Opennings: aberturas
Operate on: operar
Operate: operar
Opposite: ao contrário, em frente, oposto
Oppressive: opressivo
Opt: optar
Or else: se não, ou não, ou então, ou senão
Or even: ou mesmo
Orator: orador
Orbit: órbita
Orchard: pomar
Order: encomenda, encomendar, pedir; ordenar, ordem, pedido, fazer pedido
Ordinarily: costumeiramente
Organize: organizar
Ornamental: decorativo, ornamental
Otherwise: de outra forma
Otter: lontra
Ouch: ai (dor física)
Ought: devia
Ounce: onça
Oust: derrubar, expulsar
Out of the blue: do nada, sem aviso
Out of the way: fora de mão
Out of: lado de fora, sem, em falta
Outcome: resultado
Outdoor: céu aberto
Outer space: espaço sideral
Outer: exterior, externo
Outside: do lado de fora
Outstand: excepcional
Outstanding: evidente, excepcional, de classe
Outward(s): para fora
Oven gloves: luvas (cozinha)
Oven: fogão, forno
Over and over again: uma e outra vez, repetidas vezes
Over and over: repetidas vezes
Over here: aqui
Over there: lá, acolá, aí
Over: por cima de, super, a cima
Overalls: macacão
Overcoat: sobretudo
Overcome: superar
Overdrawn: descoberta; exagerar; ultrapassado
Overestimating: superestimar
Overflow: transbordar
Overhead locker: compartimento superior
Overjoyed: muito feliz, radiante
Overlook: negligenciar, deixar passar, não perceber
Overlooking: com vista para
Overnight: durante a noite, de noite, fazer hora extra
Overpass: viaduto
Overreact: reagir exageradamente
Overseas: outro país
Oversleep: dormir demais
Overtake: ultrapassar
Overtime: horas extras
Overtired: exauto
Owe: dever
Owing to: devido a
Owner: possuidor, dono
Oxen: bois
Pack: trouxa, mochila, pacote, empacotar
Package of cigarettes: maço de cigarro
Package: pacote, empacotar
Packing: embalagem
Painting: pintura
Pair: par, parelha
Pajamas (E.U.A): pijama
Pal: companheiro
Pale: pálido; margem
Pall: pano
Palm tree: palmeira
Pancake: panqueca
Pancreas: pâncreas
Pane: vidro
Panflet: panfleto (simples)
Pans: panela
Panties: calcinhas
Pantry: despensa
Pants: calças (EUA)
Pantyhose: meia calça
Paper: papel, jornal, documento, trabalho
Paperclip: clips
Parade: desfile
Paragraph: parágrafo
Parcel: embrulho, encomenda, parcela, pacote; parcelar
Parcels delivery: entrega dos volumes
Parellel: comparar, paralelo
Parentes-in-law: sogros
Parenthesis: parêntese
Parents: mãe ou pai (mother + father), pais
Park: parquet, estacionar 
Parking brake: freio de mão
Parking lot: estacionamento
Parking: estacionamento 
Parliament: parlamento
Part time: meio período
Part: parte; separar; peça
Participate: participar
Particular: especial, particular
Particulars: detalhes, particularidades, pormenores 
Partner: parceiro, sócio
Partnership: parceria, sociedade
Part-time: meio expediente
Party is up: hora de festejar
Party: grupo, partido, festa
Partygoers: festeiros, participantes da festa, frequentadores da festa
Pass by: passar, passar por
Pass out: desmaiar
Pass: passar
Passing: morte
Passion fruit: maracujá
Past: Passado, atrás
Pasta server: servidor de macarrão
Pasta: massa (lasanha, espaguete, macarronada...)
Paste: colar (verbo); pasta
Path: caminho, trajeto
Patriarch: patriarca
Patron: patrono
Patroness: padroeira
Paved: pavimento, pavimentada
Pay a visit: fazer uma visita
Pay close attention: prestar muita atenção
Pay someone a visit: fazer uma visita a alguém
Paycheck: contracheque
Payment: pagamento
Payroll: folha de pagamento
Pea: ervilha
Peacock: pavão
Peak against: falar contra
Peak: pico
Peanut: amendoim
Pear: pera
Pedestrian walk: faixa de pedestre
Pedestrians: pedestres
Peer: par (nobre)
Pen: encurralar, escrever
Pence: centavo, dineheiro
Pencil case: estojo
Pencil holder: porta lápis
Pencil sharpness: apontadores
Pendant: pingente
Penny: centavo, vintém; dinheiro
Penpal: amigo por correspondência
Pensively: pensativamente
Perceive: perceber
Perch: poleiro
Perchance: porventura
Perform: executar, desempenhar
Performed: realizada, apresentada
Perilous: perigoso
Period: ponto final, menstruação (ciclo), período
Periodical: periódico
Perjure: perjurar
Permit: permitir 
Perplexed: perplexo
Persecution: perseguição
Perseverance: perseverança
Personnel: pessoal
Persuade: persuadir
Pertain: pertencer
Petition: petição, pedir, requerer
Petrochemical: petroquímico
Petrol: gasolina
Pharmacy: farmácia (manipulação)
Pheasant: faisão
Phenomena: fenômenos
Phenomenon: fenômeno
Photo(graph): fotografia
Piano(forte): piano
Pick on: pegar no pé
Pick out: escolher, selecionar
Pick pocket: batedor de carteira
Pick up: pegar
Pick you up: pegar você
Pick: pegar, apanhar, colher
Picnic: piquenique
Picturesque: pitoresco
Piece of cake: muito fácil
Piece of clothing: peça de roupa
Pigeon: pomba
Pile: pilha
Piled up: empilhados
Pillar: coluna, pilar
Pillow case: fronha
Pillow: travisseiro, almofada
Pin: alfinete
Pincers: torquês, pinça, alicate 
Pinch: pitada, aperto, beliscar, apertar, comprimir
Pine: pinho, pinheiro
Pineapple: abacaxi
Pioneering: pioneiro
Pipe: cano, tubo; cachimbo 
Pitch: passo, arremesso; lançar
Pitcher: jug: jarra
Pity: pena, piedade; lamentar
Pizza cutter: cortador de pizza
Place: lugar, colocar, fazer pedido, faça suas apostas
Plain: planalto, planície
Plaintiff: queixoso
Plan: planejar
Plank: prancha
Plant: planta, plantar; fábrica, usina
Plate: prato
Play a role: fazer um papel (função)
Play about: perder tempo
Play: peça teatral
Playing cards: cartas de jogar
Plays: peças teatrais
Pleasant: agradável
Please, don't disturb yourself: não se incomode
Please: por favor; agradar
Pleased to meet you: muito prazer
Pleased: satisfeito
Pleasing: agradável
Pleasurable: agradável
Plenty of room: muitas vagas
Plenty of: suficiente, bastante, muitos, muito de, um grande número de, grande quantidade
Plenty: fartura, bastante, muito
Pliers: alicate
Plot: enredo
Plough: lavrar, cultivar
Plumber: bombeiro hidráulico
Plunger: desentupidor
Plus: mais
Poem: poema
Poetry: poesia
Point out: indicar 
Point: apontar, ponto
Pole: poste
Police department: delegacia
Police station: delegacia de policia
Policy: política
Polish: polir
Polish: polonês, polir
Polite: polido, cortês, educado
Politician: político
Polka dot suit: terno de bolinha
Pollution: poluição
Poltry: ave (butcher shop: açougue)
Pond: lago artificial
Pony tail: rabo de cavalo
Pool: piscina
Poor: pobre (má qualidade ou financeiramente ou coitado)
Pop: estourar, estouro
Populate: povoar
Populous: populoso
Porch: varanda
Pork: porco 
Butcher shop: açougue
Port: porto
Porter: porteiro, moço
Portfolio: pasta
Portico: pórtico
Portrait: retrato
Possess: possuir
Post: cargo
Postage stamp: selo postal
Postage: franquia, postagem
Postcard: cartão postal
Posterior: posterior
Post-office: correio
Postpone: adiar, postergar, transferir
Pot: pote, panela, vaso
Poultry: aves domésticas
Pound: libra
Pour: derramar (colocar), por
Pouring down: escorrendo
Pouring rain: tempestade
Powder: pó; pó de arroz; pó medicinal; pólvora
Poweful: poderoso
Powerless: impotente
Pox: varíola
Practical jokes: brincadeiras
Practical: prática
Practice: prática, praticar
Praise: louvar, elogiar, louvor, elogio
Prankster: brincalhão
Pray for: rezar para que alguma coisa aconteça
Preach: pregar (pregador)
Preassure cooker: panela de pressão
Predict: predizer
Prediction: previsão
Prefer: preferir
Pregnancy: gravidez
Prejudice: preconceito
Premises: premissas; edifício(s); sede
Prepare: preparar
Presence: presença
Present: apresentar
Presentable: apresentável
Presentation: apresentação
Presented: apresentado
Press: imprensa
Presumption: presunção
Presumptive: presuntivo
Pretend: Fingir
Pretty much: muito mesmo
Pretty: muito
Prevent: previnir, evitar, impedir
Prevented: prevenido
Prevention: prevenção
Preventive: preventivo
Previous: anterior
Price: preço
Prick: espinho; picar, picada
Prickle: espinho
Pride: orgulho
Principal: principal; diretor de escola
Principle: princípio
Prior: prior
Prioress: prioresa
Private: particular, soldado
Privilege: privilégio
Prize: prêmio
Probability: probabilidade
Probable: provável
Procedure: procedimento
Proceed: proceder
Proceeds: renda, rendimento
Procure: procurar
Produce: produzir
Profile: perfil
Profit: lucro
Profound: profundo
Programme: programa
Prohibit: proibir
Prohibited: proibido
Prohibition: proibição
Prom: baile de formatura
Promote: promover
Promptly: prontamente
Prone: propenso
Pronounce: pronunciar
Propeller: hélice 
Proper: próprio
Properly: adequadamente, corretamente, devidamente
Property: propriedade
Proposal: proposta
Propose: propor
Proposition: proposta
Proprietor: proprietário
Prosecutor: autor, querelante, promotor
Prosperity: prosperidade
Protest: protestar
Proud of: orgulho de
Prove: provar
Proverbial: proverbial
Provide: fornecer, proporcionar
Publicize: tornar público
Publish: publicar
Pull down: demolir
Pull offs: área de descanso
Pull out couch: sofá-cama
Pull over: encostar
Pull up: puxar para cima
Pull: puxar
Pump iron: malhar, fazer exercício
Pump: bombear
Punch: murro
Punched: atingido
Punich: punir
Punishment: castigo
Puppies: filhotes de cachorro
Purchase: compra (formal), aquisição, comprar, adquirir
Purpose: propósito, finalidade
Purposely: intencionalmente
Purse: bolsa
Pursue: buscar
Push ups: flexões
Push your luck: tenta a sorte
Push: puxar
Put a garment on the test the fit and appearance: experimentar roupa
Put down the price: baixar o preço
Put into: dedicar
Put it on: veste-o, coloque isso
Put on: vestir, apagar (fogo)
Put our heads together: botar nossas cabeças para funcionar
Puzzle: enigma
Puzzling: intrigante, enigmático, surpreendente
Pyjamas: pijama 
Quadruple: quádruplo 
Quantity: quantidade
Quarrel: discutir, questionar, brigar
Quarrelsome: brigão
Quarter: quarto (de hora); quarta parte; trimestre, quarteirão
Quarters: quartos; trimestres; residência; alojamento
Queer: estranho, esquisito
Quest: busca, procura
Question mark: ponto de interrogação
Quiet: sossegado, tranquilo, calmo, quieto
Quintuple: quíntuplo 
Quit: abandonar, sair, desistir, parar
Quite a lot: muito, bastante
Quite so: perfeitamente
Quite sure: bem certo
Quite: bem, muito, bastante, completamente, perfeitamente, inteiramente
Quotation marks: aspas
Quotation: cotação, citação
Quote: citar, citação
Race: corrida; raça
Rack: rack (móvel)
Radii: raios
Radish: rabanete
Radius: raio
Ragged: esfarrapado, andrajoso
Railroad: caminho de ferro, via férrea, ferrovia
Railway: caminho de ferro, ferrovia, estrada de ferro
Raincoat: capa de chuva
Ram: carneiro
Ramparts: muralhas
Random: aleatória
Rang me up: me ligou
Range: variedade, série
Rank: posto, classificação, categoria
Ransom: resgate
Rapids: corredeiras, cachoeira
Rare: raro
Rarely: raramente, dificilmente
Rate: razão; taxa; avaliar, classificar
Rather: bastante, um pouco, muito, em vez de
Razor: navalha, barbeador
React: reagir
Readable: legível
Reading light: luz de leitura
Reading: leitura
Ready set go: pronto para começar; preparar, apontar, fogo
Real estate agent: corretor imobiliário
Real: real, verdadeiro
Realize: perceber (dar-se conta), notar, estar ciente de, realizar, ter consciência de
Really: sério
Realtor: corretor imobiliário
Reappoint: reagendar
Rear door: porta de trás
Rear view mirror: espelho retrovisor
Reasonable: razoável
Rebel: rebelar-se
Recall: recordar, lembrar, recordação
Recap: recapitular
Receipt: recibo
Receive: receber
Recently: recentemente, ultimamente
Recipe: receita
Recite: recitar
Recognition: reconhecimento
Recognize: reconhecer
Recommend: recomendar
Record: disco, registro, ficha, documento, gravar, registrar, recorde
Recorder: gravador
Recover: recuperar
Recreation: recreação, lazer
Recreational: recreativo
Red hair: cabelo ruivo
Red haired: de cabelo vermelho
Redberry: amora (vermelha)
Redhanded: no flagra
Redo: refazer
Reduce: reduzir
Reef: recife
Refer: referir
Reference: referência
Re-filled: reencher
Reflect: refletir
Refrigerator: geladeira
Refuge: refúgio
Refugee: refugiado
Refusal: recusa
Refuse: recusar
Regard: considerar
Regarding: a respeito de, sobre
Regardless: independentemente, de qualquer modo, de qualquer maneira
Regards: cumprimentos
Regret: arrepender-se, lamentar, arrependimento, remorso, pesar
Regularly: regulamento
Rehearsal: ensaio
Rehearse: ensaiar
Reimbursement: reembolso
Rein: direção
Reinforce: reforçar
Rejoice: alegrar-se
Relate: relatar
Relation: relação, parente, relativo
Relationship: relacionamento
Relative: parente, relativo, comparativo 
Relaxation: descanso, relaxamento
Release: lançamento, libertação, liberar, libertar
Reliable: confiável
Relieve: aliviar, diminuir
Reluctance: relutância
Rely on: confiar
Rely: Contar com
Remain: permanecer, ficar
Remarks: anotações, observações
Remind: recordar
Remittance: remessa
Remove: retirar, remover
Rend: rasgar
Renew: reverter
Renewal: renovação
Renovate: reformar, renovar
Rent: arrendar, alugar, aluguel, renda  
Repair: concerto
Repent: areepender-se
Replace: repor, substituir
Replete: repleto
Reply: responder, resposta
Report card: boletim
Report: relato, reportagem, notícia, reportar, relatório, informar, comunicar, relatar
Reported speech: discurso indireto
Repouse: repouso
Representative: representante
Request: pedido, pedir, solicitar
Require: pedir, requerer, exigir
Requirement: requisito, requerimento
Rescue: resgatar, salvar, salvamento, resgate
Research: pesquisa
Resemblance: semelhança
Resemble: assemelhar-se
Resent: reenviar, ressentir
Reservation: reserva
Reservoir: reservatório
Reside: residir
Resignation: renúncia
Resist: resistir
Resolve: resolver
Rest: descanso, descansar, restante
Resting área: área de descanso
Resting day: dia de descanso
Restroom: banheiro
Result: resultar, resultado
Resume: resumo, curriculum vitae
Resupply: reabastecer
Retail: varejo
Retake: retomar
Retire: aposentar; retirar
Return ticket: passagem de ida e volta
Return: devolver, retornar, repitição; volta, voltar; lucro
Returns: repetições; voltas; resultados de eleições; tábuas estatísticas; lucros
Reunion: reunião
Reveal: revelar
Revere: reverenciar
Reverend: reverend
Reversal: reversão
Reverse: marcha ré; reverso, inverso, reverter, inverter
Revise: rever, revisar
Revolve: revolver, girar
Reward: premiar, recompensar, recompensa
Rewind: voltar
Rib: costela
Rice: arroz
Riches: riqueza
Richness: riqueza, opulência, abundância
Rid: livrar-se
Ride on: apoiar-se, andar em ou sobre
Ride: corrida, carona
Right after: após, logo após, logo a seguir, logo depois
Right away: imediatamente
Right hand: à direita
Right here: bem aqui
Right now: imediatamente
Rights: direitos
Ring: tocar (sino, campainha), anel
Rip: rasgar
Ripe: maduro
Rise: aumentar, subir, levantar-se, nascer (sol), aumento
Risk: arriscar(-se)
Rive: rachar, fender
Rivet: rebitar, rebite
Road (rd): estrada, caminho
Roar: rugido
Roast: assar (assar no sentido de esquentar)
Rob: roubar
Robber: ladrão
Robbery: assalto, roubo
Robe: robe, manto, roupão, túnica
Rock: balançar
Rocket Launcher: lançador de foguete
Role play: atuar
Role playing game (RPG): jogo de interpretação de papéis
Role: papel (atuação)
Rollaway bed: cama de rodinhas
Rolling pin: rolo de amassar massa
Rooftop: cobertura, terraço (a cima do topfloor)
Rooster: galo
Root: raiz
Rope: corda
Rot: apodrecer
Rotten: podre (estragar)
Rough it: viver sem conforto, viver uma vida rústica; áspero
Rough: duro, áspero, rugoso, rude
Round and round: em círculos
Round: em volta de, por todo, em todas as direções, redondo, rodeado por, em volta, redondeza
Route: percurso, linha, rota, caminho
Routine: rotina
Row: fila, remar
Rub: esfregar
Rubber: borracha 
Rubbish: lixo, refugo
Rudder: leme
Rude: grosseiro, rude
Ruffle: dobra, prega
Rug: tapete
Rugged: áspero
Ruin: ruina
Rule: regra, governar, comandar
Run across: encontrar, depara com
Run after: correr atrás
Run away: fugir
Run back: voltar correndo
Run off: partir, ir-se embora; imprimir ou copiar
Run out of: ficar sem (sentido de acabar)
Run over: atropelar; transbordar, derramar-se
Run short of: ficar sem tempo
Run through: percorrer rapidamente, recapitular rapidamente; desperdiçar
Run: correr, tocar (uma empresa)
Running water: água corrente
Running: correndo, corrida, administração, direção, concorrendo
Runs: temporadas, períodos em cartaz
Rush: correr, correria, precipitar-se
Rut: rotina
Rye: centeio
Saddle: sela (cavalo), selar
Safe and sound: são e salvo
Safety: segurança
Sail vessel: navio à vela
Sail: velejar, vela
Sailor: marinheiro
Sake: causa, amor
Salami: salame
Salary: salário
Salmon: salmão
Salt shaker: saleiro
Salute: saudar, saudação, continência
Sample: amostra
Sandals: sandália, chinelo (feminino)
Sands: banco de areia; praia
Santa claus: papai noel
Santa: papai noel
Sauce: molho
Saucepan: caçarola
Saucers: pires
Save: salvar, economizar, poupar, guarder
Saving: economias, poupança, exceto 
Saw: serrar, serra, serrote
Say it like you mean it: fala sério, diga a verdade
Say: dizer, sugerir
Scab: fura greve
Scald: escaldar, queimadura
Scales: balança
Scandal: escândalo
Scarcely ever: quase nunca
Scarcely: mal, dificilmente, apenas, quase não
Scarecrow: espantalho
Scarf: cachecol
Scatter: espalhar
Scenery: cenário
Scent: cheiro, perfume
Schedule: agenda (horários), compromissos diários, cronograma, programar, planejar, horário
School year: ano letivo
School: cardume, escola
Schoolboy: aluno, estudante
Schoolfellow: colega de escola
Schoolmate: colega
Schooner: escuna
Sci-fi (science-fiction): ficção científica
Scold: ralhar, repreender
Scooter: lambreta, patinete
Score: ponto, contagem; dezenas, várias
Scotch tape: fita adesiva
Scramble: mexer (ovos)
Scratch: arranhar, coçar
Screen: tela
Screw: parafuso
Screwdriver: chave de fenda
Sculpture: escultura
Sea food: frutos do mar 
Seal: foca; selar
Sealing wax: lacre
Seamstress: costureira
Season: temporada teatral
Seat oneself: sentar-se
Secondly: em segundo lugar
See what: está vendo
See you around: vejo você por aí
See you tomorrow: até amanhã
Seem like: parece que
Seethe: cozer, ferver
Segregation: discriminação, separação
Seize: confiscar
Seldom: raramente
Select: selecionar
Self control: auto domínio
Self inflicted wound: ferimento auto infligido
Self locking: travamento automático
Self: mesmo, auto, pessoa, personalidade, autonomia
Selfish: individualista
Self-protection: proteção própria
Self-taught: autodidata
Sell: vender (to - for)
Semester: semestre
Semicolon: ponto e vírgula
Sempster: costureiro
Sempstress: costureira
Senate: senado
Sender: remetente
Sense: sentido, bom senso
Sensible: sensato
Sensitive: sencível
Sentence: frase
Serve: servir
Serving spoon: colher de servir (arroz)
Servitor: criado
Set an example: dar um exemplo
Set down: colocar, pôr
Set forth: encaminhar-se
Set free: libertar
Set off: pôr em movimento
Set up: configuração; estabelecer; montar
Set: conjunto, aparelho; pôr; estabelecer; determinar, ajustar, fixar; lance (escada)
Settle: resolver, decidir
Settlement: assentamento, liquidação, acordo
Several: vários
Severe: severo
Sew: coser, costurar, pregar (botão)
Sewer: esgoto
Sewing machine: máquina de costura
Sewing: costura
Shade: sombra
Shades: tons, sombras
Shake the head: balançar a cabeça (para os lados)
Shake: vitamina, chacoalhar
Shallow: raso, superficial
Shaman: xamã
Shamefaced: tímido, modesto, encabulado
Shampoo: lavar o cabelo
Shamrock: trevo
Shank: perna, canela
Shape: forma
Share: dividir, compartilhar
Shareholders: acionistas
Sharp: afiar, agudo, pontudo, apontar; em ponto (horas), ligeiro, rápido (esperto, raciocínio)
Sharpen: afiado
Shave: barbear, raspar
Shawl: xale
She dumped him: ela o dispensou, descartou
She has just left: ela acabou de sair
She is on her way: ela está a caminho
She proved me wrong: ela provou que eu estava errado
Sheaf: feixe
Shed: derramar, soltar, deixar cair; abrigo
Sheet: lençol, folha
Shelf: prateleira, estante
Shell fish: mexilhão
Shell: concha (molusco), casca (nozes, ovo)
Shelter: abrigo, refúgio
Shelve: inclinar-se, descer em declive
Shield: escudo
Shift stick: câmbio, caixa de marcha
Shift: trocar
Shin: canela (perna)
Shine: brilhar
Ship yard: porto
Ship: navio
Shipment: envio, embarque, expedição, remessa, carregamento
Shipwreck: naufrágio
Shirt: camisa (botão)
Shiver: tremer
Shoelace: cadarço
Shoot (someone) a dirty look: olhar com desaprovação
Shoot: tiro, atirar, dar tiros, atirar, filmar; lançar, arremessar
Shooting star: estrela cadente
Shop for: ir as compras
Shop window: vitrine
Shop: fazer compras
Shopper: comprador
Shopping list: lista de compras
Shopping mall: shopping center
Shore: costa, praia
Shortly after: logo após
Shortly: imediatamente
Shorts: calção
Shot: tiro
Shout one's head off: gritar feito louco, berrar a plenos pulmões
Shout: gritar
Show: show, mostrar, exibir, aparecer
Showdown: cartas na mesa, confronto
Showed up: apareceu
Shower brush: escova (corpo)
Shower: banho
Shred: retalhar
Shrew: megera
Shriek: gritar
Shrink: encolher, contrair, reduzir
Shrive: ouvir em confissão
Shrouve: ensopado
Shut the door: feche a porta
Shut ty our mouth up: calha a boca
Shut up: calha a boca
Shut: fechar
Sibling: irmão, irmã (sister + brother)
Sick for: ansioso por; com saudade de
Sick of: doente de; farto de, cansado de
Sick-headache: enxaqueca 
Side mirror: retrovisor lateral
Side table: mesa de canto
Sideburns: costeleta
Sidewish: acompanhamento
Sieve: peneira, crivo
Sight: vista
Sightseeing: visita guiada, excursão, passeio turístico
Sign: assinar, sinal, placa
Signature: assinatura
Significance: significado, importância
Signify: significar
Silent movie: filme mudo, cinema mudo
Silent: silencioso
Silk: seda
Silly: bobo, idiota
Similar: parecido
Simmer: cozer
Sincere: sincero
Sincerely yours: atenciosamente
Singe: chamuscar
Single move: único movimento
Singly: individualmente, isoladamente
Sink: afundar, submergir; pia, torneira
Sire: senhor
Siren: sirene
Sit down: sentar-se
Sitting room: sala de estar
Situate: situar
Skill: habilidade
Skinny: magricela (muito magro)
Skirt: saia
Skunk: gambá
Skyscraper: arranha-céu
Slam the door: bata a porta
Slang: calão (palavra grosseira, palavrão), gíria
Slattern: mulher desalinhada
Slavery: escravidão
Slay: matar
Sleep like a tog: dormir como um bebê
Sleepless: insone
Sleeve: manga
Slender: delgado, esguio, fino, esbelto
Slice: fatia
Slide: escorregar, resvalar, deslizar
Slightly: ligeiramente, levemente
Slim: em forma, magro, fino
Sling: tipoia, arremessar, atirar, suspender
Slink: esquivar-se, safar-se
Slip out: sair, escapar
Slip: deslizar
Slipery: escorregadio
Slippers: chinelos (masculino)
Slit: rachar, rasgar
Slope: declive, obliquidade
Sloth: preguiça (animal)
Sloven: desfiado, homem desmazelado
Slut: vagabunda
Sly: astuto
Small intestin: intestino delgado
Smart: esperto
Smite: golpear
Smoke: fumar, defumar, fumaça
Smooth hair: cabelo liso
Smooth: liso, suave
Smuggle: contrabandear
Smuggling: contrabando
Snack bar: lanchonete
Snack: lance, salgadinho
Snap: falar asperamente
Sneakers: tênis
Sneaking: penetrar
Sneeze: espirrar
Snore: roncar
So as to: afim de
So bad: tanto
So cute: tão fofinho
So far: até agora
So long: até breve, até logo
So many: tantos (as)
So mean: tão malvado
So much: tanto
So that: a fim de que, para que, de modo que, de maneira que, e daí
So... That: tão... que 
Soak: encharcar, ensopar
Soap opera: novela
Soap: novela, sabão
Social security: previdência social
Socks: meias
Soda: refrigerante
Sofa: sofá
Soft drink: refrigerante
Soft: suave, leve
Soften: suavizar
Soil: solo
Soken: ensopado
Solar system: sistema solar
Sold out: esgotado
Sole: linguado (peixe)
Sole: único, exclusivo; linguado (peixe)
Solemn: solene
Solve by using figures: solucionar com o uso de figuras 
Solve: resolver
Some dude: um cara
Some: algum (a), um pouco de 
Somebody else: alguém mais
Somehow: de alguma forma, algum modo
Someone else: outra pessoa
Someone's future looks bright: ter um futuro brilhante
Sometimes I: por vezes, às vezes
Sometimes: algumas vezes, às vezes, eventualmente 
Songster: cantor
Son-in-law: genro
Sonnet: soneto
Soprano: soprano
Sorcerer: feiticeiro
Sorethroat: dor de garganta
Sorrow: tristeza, dor, sofrimento, pesar
Sort: espécie, tipo
Sounds nice: parece (soa) legal
Sounds weird: parece (soa) estranho
Sounds: soa
Soup: sopa
Sour: ápero, azedo, triste
South: sul, meridional 
Southern (adj): sul, meridional, austral
Souvenir: lembrança
Sow: javalina, porca (pronúncia sáu); semear, espalhar, propagar (pronúncia sôu)
Soybean: soja
Space: espaço, vaga (estacionamento)
Spaceship: espaçonave
Spank: espancar
Spare time: tempo livre
Spare tire: estepe, pneu traseiro
Spare: vago
Sparkle: polvilhar
Sparkling mineral water: água mineral com gás
Sparrow: pardal
Spatula: espátula
Speak about: falar a respeito de 
Speak for: falar a favor de
Speak of: falar de, falar a respeito de 
Speak on: falar a respeito de 
Speak to: dirigir-se a; saudar, cumprimentar
Speak upon: falar a respeito de
Speakers: autofalantes
Spear: lança
Specify: especificar
Spectable: espetáculo
Spectables: espetáculos; óculos
Speech: discurso
Speechless: mudo, sem voz
Speed bump: lombada
Speed ticket: multa de velocidade
Speed: apressar-se, velocidade
Speedometer: velocímetro
Spellbound: fascinado
Spill: derramar (deixar cair), entornar
Spin: fiar, fazer girar
Spinach: espinafre
Spinster: solteira
Spirits: espíritos, bebida alcoólica (destilado)
Spit: cuspir
Splash: salpicar
Spleen: baço
Splendid: esplêndido
Split out: romper, quebrar, partir
Split up: separar
Split: rachar, dividir, divisão
Spoil: estragar (no sentido de errar na receita)
Spoiled child: criança mimada
Spoiled kid: criança mimada
Spoiled: estragado, mimado
Spoonful: colherada
Spot: localizar, mancha, ponto
Sprain: torcer
Spread: expandir, espalhar, expansão
Spring: primavera; saltar, nascer, brotar (crescer), fazer explodir
Sprinkle: salpicar
Spry: ativo
Sputter: borrifar, falar atabalhoadamente
Sqeeze: espremer
Squalor: miséria
Square meter: metro quadrado
Square: praça; quadrado
Squash: abóbodas (tipos)
Squealer: dedo duro
Stable: estável
Stablish: estabelecer
Stablishment: estabelecimento
Staff: cajado, pauta musical, funcionário, pessoal, equipe
Stag: cervo
Stage: palco, etapa
Staged: encenado
Stain: manchar
Stair: degrau
Stairs: escada
Stake: bife
Stallion: garanhão 
Stammer: gaguejar
Stamp: selo
Stand by: permanecer perto, estar presente, ser espectador, ficar a postos, ficar ao lado
Stand it: aguenta
Stand tall: defender a posição
Stand the chance: estar sujeito a
Stand up (quando sentado): levantar-se, ficar de pé
Stand: ficar, aguentar, ficar parado em pé, esperar
Standard: padrão, norma
Standing: de pé
Stanza: estrofe
Stapler: grampeador, grampo
Stare at: encarar, olhar atentamente em
Stare: encarar (mais agressivo), ficar admirado, olhar fixo, encarar
Starfruit: carambola
Started getting: começou a ficar
Starter: entrada
Starting over: começar de novo
Starve: definhar, morrer de fome
State: afirmar, declarar
Statement: declaração, depoimento
Statesman: estadista
Station wagon: perua
Stave: arrombar, perfurar
Stay: estadia
Staying up: ficando acordado
Steadily: firmemente
Steady: estável
Steak: bife
Steal: roubar
Steam: vaporizar, cozer ao vapor, vapor
Steamer: navio a vapor
Steep: inclinado, íngreme
Steering wheel: volante
Stem: talo, tronco
Step: degrau, passo
Step-father: padrastro
Step-son: enteado
Stereo system: rádio
Stew: bobó, ensopado, cozido
Stewardess: comissária
Stick: colar, grudar, colar, enfiar, cravar, fincar, apegar-se; vara, pau
Sticker: adesivo
Sticky: pegajoso
Stiff: rígido, duro
Still: ainda, parado, ainda assim (contraste)
Stimuli: estímulos
Stinck: feder, horrível
Sting: picar, ferretoar
Stingy: mesquinha, pão duro
Stink: exalar mau cheiro
Stir: mexer (com colher), mover(-se)
Stock: sortido, fornecimento; estoque
Stonemason: pedreiro
Stool: banco (bar), banquinho
Stoop down: abaixar-se
Stoop: varanda; inclinar-se
Stop flying around: pare de dar voltas, fazer rodeios
Stop fooling me around: pare de me fazer de idiota
Stop overnight: pare durante a noite, pernoitar
Stoped smoking: parou de fumar
Stoped to smoke: parou para fumar
Storage: depósito
Store: armazenar
Store-house: depósito
Storey (UK): andar (prédio) 
Story: andar (prédio - US), história, relato, reportagem, descrição, narrativa
Stout: robusto, forte, corpulento
Stove: fogão
Straighforward: honesto (correto)
Straight hair: cabelo liso
Straight up: direto para cima
Straight: reto, direto, diretamente
Straighten: alisar, endireitar
Strainer: peneira
Strata: estratos
Stratum: estrato
Stream: riacho, córrego, correnteza
Streaming: esvoaçante
Streetcar: bonde
Strength: força
Stress: estresse, tensão; salientar, sublinhar, enfatizar
Stretch: alargar, alongar, esticar, esticar, trecho, extensão
Strew: juncar, espalhar
Stricken: acometido
Strict: estrito, severo, rígido
Stride: bater
Strife: luta, briga, contenda, conflito
Strike: atacar, atingir, dar pancada, bater; greve
String: encordoar, cordel
Stripe: listra
Strive: esforçar-se, empenhar-se
Stroke: golpe, pancada
Strolling around: passear
Structural: estrutural
Structure: estrutura
Strugg: luta
Stuck: preso, emperrado, emperrar
Stuffs: coisa (não vai ao plural)
Subject: assunto, matéria
Subscription: inscrição, subscrição, assinatura
Subside: diminuir, mais baixo
Subsidy: subsídio
Suburb: subúrbio
Subway: metrô 
Succeed: ser bem-sucedido
Successfull: bem-sucedido
Such a: tal, assim
Such as: assim como, tal como
Such... That: tão... que
Such: tal, tais
Sudden: repentino
Suddenly: subitamente, de repente
Suffering: sofrimento
Sufficient: suficiente
Suffocation: sufocar
Sugar bowl: açucareiro
Suggest: sugerir
Suggestion: sugestão
Suit: terno, fato
Suitable: apropriado, conveniente
Sultan: sultão
Sum up: resumir
Sum: quantia, soma, montante
Summarize: resumir
Summary: resumo
Sunglasses: óculos de sol
Sunrise: nascer do sol, madrugada, ao amanhecer
Sunset: pôr do sol
Superb: soberbo
Supper: ceia
Supply: suprir, fornecer
Support: apoio, suporte, suportar, apoiar
Surely: certamente 
Surface: superfície
Surgeon: cirurgião
Surname: sobrenome
Surrender: render-se, abandonar, entregar, rendição, nenunciar
Surrounded: circundado, cercado
Surroundings: ambiente, arredores
Survey: pesquisa
Survivor: sobrevivente
Suspend: suspender
Suspicious: desconfiado
Sustain: sustentar
Swain: jovem camponês; pastor
Swallow: andorinha; engolir
Swamp: pântano
Swarm: enxame
Sway: oscilação, balançar
Sweater: suéter
Sweatshirt: suéter, agasalho
Sweep: varrer; vasculhar
Sweet talk: conversa fiada
Sweetness: doçura
Swell: inchar
Swerve: desviar
Swifty: rapidamente
Swimming pool: piscina
Swindle: tramoia
Swindler: trapaceiro, pilantra, malandro
Swing: balançar
Swinge: açoitar
Switch: interruptor
Sword: espada
Swrimp: camarão
Sympathize: solidarizar, simpatizar
Syrup: xarope
Table cloth: toalha de mesa
Table lamp: abajur
Table: mesa (refeição)
Tail door (usado para descarga ou carga militar): porta de trás
Tail light: farol traseiro
Tail: cauda, rabo
Tailor: alfaiate
Take (somebody) out: levar alguém para sair, remover algo
Take (something) apart: separar, demonstrar
Take (something) off: tirar (sentido de arrancar), decolar
Take (something) out: levar alguém para sair, remover algo
Take a break: fazer uma pausa, dar uma folga
Take a chance: arriscar
Take a close look at: dê uma olhada de perto
Take a course (lessons): fazer um curso
Take a last farewell: dizer o último adeus
Take a long, hard look at something: dar uma olhada bem atenciosa a algo
Take a look (at): dar uma olhada
Take a nap: tirar um cochilo/ soneca
Take a rest: fazer um descanso
Take a test: fazer um exame
Take a time to smell the flowers: aproveite a vida
Take a trip: fazer uma viagem
Take a walk: dar uma caminhada
Take advice: aceitar conselhos
Take away: levar (embora)
Take back: levar de volta
Take care of: tomar conta, cuidar de
Take care: cuidar-se, tomar cuidado, ser cuidadoso
Take classes: fazer aulas
Take control of: assumir o controle, a responsabilidade ou a posse de algo
Take effect: vigorar a partir de, ter, fazer efeito
Take into consideration: levar em consideração
Take it as: crer, supor, aceitar como...
Take it or leave it: é pegar ou largar
Take it: pegue
Take lessons: fazer aulas
Take me as I am: aceite-me como eu sou
Take notes: tomar notas, fazer anotações
Take off: descolar, levantar voo; tirar, despir-se
Take on: adquirir, passar a ter; assumir, aceitar algo; admitir, contratar
Take one's time: tomar seu tempo, não ter pressa
Take over: assumir controle, a responsabilidade ou a posse de algo, tomar conta, tomar rédeas
Take part: fazer parte, particular
Take personal: ofender-se
Take pictures: tirar fotos
Take place (programada): acontecer, realizar
Take steps: iniciar preparativos
Take the blame: assumir, levar a culpa
Take the opportunity: aproveitar a oportunidade
Take the responsability: assumir a responsabilidade
Take the temperature: tirar a febre
Take this decision: toma a decisão
Take this trip: fazer esta viagem
Take turn: revesar
Take up arms: pegar armas
Take up something: começar a estudar ou praticar algo
Take your time: não se apresse, não tenha pressa
Take: pegar, tomar, levar
Takes it all: leva tudo
Takes part on: participar de
Tale: conto, história
Talk about: falar a respeito de 
Talk of: falar em, falar de, falar a respeito de
Tame: domesticar, domar, doméstico, manso
Tangible: tangível
Tangled: enrolada
Tank top: regata
Tap: torneira, ralo
Tart: pastel
Task: tarefa, afazer
Tasks: afazeres
Taste: provar, paladar, sabor, gosto
Tax: imposto
Taxi: táxi
Taxpayer: contribuinte
Teachable: educável, suscetível de ensino
Teaching activities: atividades docentes
Teapot: bule de chá
Tear: rasgar; lágrima
Teat pot: chaleira 
Technique: técnica
Tedious: monótono
Teenage: adolescente (adjetivo)
Teenager: adolescente (substantivo)
Telecast: televisionar
Teller: caixa
Temper: temperamento, gênio
Tempt: tentar
Temptation: tentação
Tend: tender
Tender: proposta, concurso, macio
Tennis shoes: tênis
Tense: tempo (em gramática)
Tent: tenda
Terms: termos, condições
Terrible: terrível
Terrific: formidável, bárbaro, incrível, sensacional, espetacular
Terrorist: terrorista
Terrorize: aterrorizar
Test: testar
Thames: Tâmisa
Thank god it's Friday (T.G.I.F.): graças a Deus é sexta-feira
Thank god: graças a Deus
Thanksgiving day: dia de ação de graças
That is: isto é
That much: tanto assim
That's all: isso é tudo, é tudo
That's bad: isso é ruim
That's good: que bom
That's it: isso mesmo, é isto
That's why: that's the reason: razão pelo qual, é por isso que
That's the thing: é isso mesmo
The day before yesterday: anteontem
The devil looks after his own: não entendo como as coisas funcionam para..., o diabo cuida dos seus
The drinking kind of person: o tipo de pessoa que bebe
The dying: o moribundo, morto
The fee is on us: a taxa é por nossa conta
The former: aquele(s), aquela(s)
The latter: este(s), esta(s) (exprime ordem, sequência) - correlativo de former
The less... the less: quanto menos... menos
The living: vivo
The more... the more: quanto mais... mais
The one who: aquele que
The same as: o mesmo que, os mesmos que
The soon the better: o mais cedo possível
The whole day: todo o dia
Theater: teatro
Thee: pronome pessoal oblíquo 2ª pessoa do singular 
Theft: roubo
Them all: todas
Then: então, depois
Thence: de lá
Theory: teoria
There is going to be: haverá
There may be: pode ser que haja
There to be: haver
There will be: haverá
There you are: aqui está
Thereby: por esse meio
Theredore: portanto, mais tarde
Therefore (causa e resultado): portanto, assim sendo, por conseguinte, por isso
Thereupon: logo após, depois disso
Thermos bottle: garrafa térmica
Theses: teses
Thesis: tese
They were supposed to do: eles deveriam ter feito
They've just: eles acabaram de
Thick: grosso, espesso, cheio
Thicker: grosso
Thigh: coxa
Thin: magro, fino
Thine: pronome possessivo 2ª pessoa do singular
Think about: pensar em
Think it over: pense sobre, pense bem, pondere
Think of: imaginar; pensar me
Thirdly: em terceiro lugar
Thirsty: sedento
This far: até aqui
This one: esta (one só acompanha)
This way: por aqui, deste jeito
Thither: para lá
Thorn: espinho
Thoroughly: completamente, inteiramente
Thou: pronome pessoal reto 2ª pessoa do singular
Though: no entanto, entretanto, contudo, embora, ainda que 
Thoughtful: atencioso
Thoughtless: desatenção
Thread: ameaça
Three times: três vezes
Threefold: triplo
Three-speed: três marchas
Threnchcoat: capa de chuva, casaco de chuva
Thrice: três vezes 
Thrifty: econômico
Thrill: vibração
Thriller: suspense (em inglês): suspense
Thrive: prosperar
Throat: pescoço
Through and through: de lado a lado
Through: através de
Throughout: de um extremo a outro, por todo (a), em todo (a)
Throw away: jogar for a, descartar
Throw... At: arremessar... Contra (alvo, pessoa)
Throw... To: jogar... Para (uma pessoa)
Throw: jogar, atirar, lançar, arremessar
Thrust: empurrar
Thumb: pedir carona, polegar
Thus (causa e resultado): assim, assim sendo
Thy: pronome possessivo 2ª pessoa do singular
Tick: carrapato
Ticket: ingresso, multa
Tidy: arrumado
Tie: atar
Tight: apertado, estreito
Tights: meia-calça
Tile: azulejo, ladrilho, telha
Till: until: up to: até
Timber: madeira
Time off: intervalo
Time out: tempo esgotado
Time-consuming: demorado
Time-honoured: venerando
Timely: oportuno
Time-saving: poupar tempo
Timetable: calendário
Timing: cronometragem
Tinge: colorir
Tip: inclinar; dica, gorjeta
Tire: pneu, cansar
Tiring: cansativo
To a certain extent: até certo ponto
To a great extent: em grande parte
To and from: para lá e para cá
To the amount of: no total de
To the full: completamente
To this liking: do seu agrado
Toast: torrada
Toaster: torradeira
Tobacco: tabaco, fumo
Tobacconist's: charutaria
Toe: dedo do pé
Toilet paper: papel higiênico
Toilet: privada, banheiro
Toll: pedágio
Ton: tonelada
Tongs: tenaz, pinça 
Too much: demais
Too: demais
Top hat: cartola
Top: teto
Topaz: topázio
Topfloor: último andar, cobertura
Topic: tópico
Torch: tocha
Torn in peaces: despedaçado
Tortoise: tartaruga
Toss: arremessar, lançar, jogar
Tossed: arremessada
Tour: excursão
Tow car: reboque, guincho
Tow: rebocar, reboque
Towards: em direção a, para com, perto de, para, pouco antes
Towel hanger: cabide de toalha
Towering: alto, elevado
Trace: traçar, traço, vestígio, localizar
Track suits: agasalho (conjunto)
Track: vereda, trilho, caminho
Trade union: sidicato 
Trade: comércio
Traffic circle: rotatória
Traffic jam: congestionamento
Traffic light: semáforo
Trail: trilha, rastro
Trainee: treinado, estagiário
Tram: bonde 
Tramp: caminhada
Tranquilizer: tranquilizante
Transportation: transporte
Tray table: bandeja (avião)
Tray: bandeja
Tread: pisar, trilhar, esmagar com o pé
Treasurer: tesoureiro
Treat: tartar, agrado
Treatise: tratado
Treatment: tratamento
Treaty: tratado
Treble: triplo 
Trek: caminhada
Tremble: tremer
Tremendous: tremenda
Trial: julgamento
Tribute: homenagem
Trice: instante
Trick: prenda, surpresa, truque (pegadinha)
Trifle: ninharia, bagatela
Triple: triplo 
Trot: trote, trotar
Troublesome: incômodo, incomodativo, aflitivo
Trousers: calça (UK)
Trout: truta
Truck: caminhão
Truly yours: atenciosamente
Trunk: tronco, baú, mala, porta mala
Try on: experimentar 
Try out: provar, experimentar, testar 
Try: tentar, testar, provar, experimentar
T-shirt: camiseta
Tucked: colocado, inserido
Tumble down: rolar
Tumble: cair
Tune: tom, melodia; afinar
Tunic: túnica
Turbulence: tubulência
Turf: gramado
Turkey: peru, Turquia
Turkish: turco
Turn a deaf ear: fazer-se de surdo
Turn back: retroceder
Turn in: ir para a cama, ir deitar-se; voltar e entrar
Turn indicator: indicador de virar
Turn off: desligar, apagar
Turn on: ligar, acender
Turn out: reunir-se para partir; levantar-se da cama; entrar em greve; tornar-se, revelar-se
Turn over: virar-se
Turn right at the (local, referência): virar a direita na
Turn right on (nome da rua, avenida, estrada): virar a direita na
Turn round: voltar-se
Turn the light: furar sinal vermelho
Turn the page over: virar a página
Turn up: chegar, aparecer subitamente; acontecer
Turn... on: ligar (o que vai ser ligado fica dentro do verbo ou turno n + o que vai ser ligado)
Turn: tornar-se, dar volta, voltar-se; virar
Turning functions: funções de mudança de rota
Turning point: ponto decisivo
Turnip: nabo
Tutor: preceptor, tutor
Tuxedo: smoking
TV set: TV
Tweezers: pinça 
Twice a: 2 vezes por
Twilight: crepúsculo
Twinkle: cintilhação
Twist: torcer
Two way street: rua de duas vias
Twofold: dobro
Two-legged: bípede
Two-way: mão dupla
Typing: datilografia
Typist: datilógrafo
UFO: OVNI
Ugh: que horror
Ultimate: último (top de linha)
Unawares: inadvertidamente, desprevenido
Unberable: insuportável
Under: debaixo de
Underage: menor de idade
Undergo: sofrer
Underground: metrô
Undergrouth: matagal, vegetação rasteira
Underneath: sob, embaixo de, por baixo de
Undertake: empreender
Underwear: roupa de baixo, roupa íntima
Undoubtedly: indubitavelmente 
Uneducated: sem educação
Unemployment: desemprego
Uneven: desigual
Unfit: fora de forma
Unfortunately: infelizmente
Unheard-of: inaudito
Union: união, sidicato
Unite: unir
Unless: a não ser que
Unlike: ao contrário de, diferente (indica o oposto de)
Unlikely: improvável 
Unmask: desmascarar
Unnatural: não natural
Unpleasant: desagradável
Unpopular: impopular
Unreliable: não confiável
Unrest: agitação, inquietação
Unsettled: instável
Up and down: para cima e para baixo
Up hill and down vale: por montes e por vales
Up hill: morro acima
Up river: rio acima
Up till now: até o momento, até agora
Up to date: em dia, até esta data, atualizado
Up to now: até agora
Up to: até
Up until now: até o momento, até agora
Up: para cima
Upon: sobre, em
Upper: superior
Uproar: tumulto
Upset: pertubado, transtornado, chateado, triste
Upstairs: para cima, andar de cima, escada a cima
Upturned: arrebitado
Upwind: contra o vento
Use up: acabar com, usar
Useful: útil
Useless: inútil
Usually: geralmente, usualmente
Utter: completo, total
Utterly: totalmente
U-Turn: retorno
Vacancy: vaga
Vaccum cleaner: aspirador de pó
Vague: vago
Vale: vale 
Valet: criado de quarto
Vallet service: serviço de manobrista
Valley: vale
Valuable: objeto de valor, valioso
Value: avaliar, valor
Vary: variar
Vauntingly: solenemente
Veg: vegetariano
Vegetable Garden: horta
Vegetable: legume
Vehicle: veículo
Vein: veia
Vending machine: máquina de comida
Vendor: vendedor
Verify: verificar
Verses: estrofe
Very likely: provavelmente
Very much: muitíssimo
Very often: frequentemente, muito frequentemente
Very soon: muito em breve
Very: muito
Vessel: navio (para carga)
Vest: colete
Vested: investido
Vicereine: vice-rainha
Viceroy: vice-rei
Victual: víveres, alimentos, mantimentos
View: visão, vista, ver
Villager: aldeão
Vinegar: vinagre
Vineyard: vinhedo
Violation: violação
Violent: violento
Virtue: virtude
Virtuoso: virtuoso
Visa: visto
Viscount: visconde
Viscountess: viscondessa
Visitor: visitante
Vitamin: vitamina (do tipo A, B, ...)
Votary: devoto
Wade: vadear
Wages: salários
Wagon: van
Waist: cintura
Wait on: esperar por (período além do período ou pessoas que estão à disposição de outros ou quando aguardamos o desenrolar de algo)
Waiter: garçom
Waiting: espera, à espera
Waitress: garçonete
Wake up (mais usual - sentido de acordar depois de permanecer deitado): acordar, levantar-se
Wake up call: serviço de despertador, chamada de despertador
Wake: despertar
Wales: País de Gales
Walk on all fours: andar de quatro
Walk the dog: levar o cachorro para passear
Wall unit: rack (móvel grande)
Wallet: carteira
Waltz: valsa
Wand: varinha
Wander: perambular, peregrinar, errar, desgarrar-se, divagar, ir de um lado para outro
Ward: enfermaria
Warder: carcereiro
Wardress: carcereira
Wardrobe: guarda-roupa
Warehouse: armazém
Warlike: marcial, bélico, belicoso
Warm: quente, morno
Warn: avisar, advertir
Warning: aviso, advertência
Was just about to: esteve prestes a
Washroom: banheiro (lavabo sem chuveiro)
Waste: lixo, resíduo; perder, desperdiçar, estragar
Watch out: tomar cuidado, cuidado
Watch your step: cuidado por onde anda, tenha cuidado
Water well: poço d'água
Wave: onda; acenar
Wax: cera, encerar
Way old fashioned: pra lá de fora de moda
Way to shy: muito tímido (way - enfatiza)
Way: modo, jeito, maneira; método; rota, caminho
We hope you enjoyed: esperamos que tenha curtido
We won't have to: nós não precisamos
We've burst in tears: nós debulhamos em lágrimas
We've got: we have: we have got: we got: we gotta: temos
Weak: fraco
Wealth: riqueza
Wealthy: rico
Weaponry: armamento
Wear: usar, vestir
Weather report: previsão do tempo, previsão da meteorologia
Weather: tempo
Weave: tecer
Wed: casar-se, unir-se
Wedding: casamento (cerimônia)
Weeds: erva daninha, erva (maconha)
Weep: chorar, lamentar
Weigh anchor: levantar ferros
Weigh: pesar
Weighing-machine: balança
Weight lifters: levantadores de peso, marombeiros
Weight: peso
Weird: esquisito, estranho
Welcome: bem-vindo
Welfare: prosperidade, bem estar
Well: bem, poço (água)
Well-bred: cortês; de puro sangue (cavalo)
Well-known: notório, bem conhecido, famoso, evidente
Well-off: abastado
Well-spoken: bem falante
Well-timed: oportuno
Well-to-do: abastado
Welsh: galês
Wench: criada de lavoura; prostituta
Wend: ir
Wet: umedecer, molhado
Wether: carneiro
Wharf: cais
What a hell is that?: que diabo é isso?
What about you: e você?
What about: que tal?
What about: que tal?
What are you up to?: o que você anda fazendo?
What do you mean?: o que você quer dizer?
What else?: o que mais?
What I have in store: o que eu tenho em mente
What next: que absurdo
What now: e agora
What of it: e daí 
What of that: e daí 
What of what: e daí 
What's the matter: qual o problema?
What's the problem: qual o problema?
What's up: e aí?, qual é?
Whatever: o que quer que, qualquer coisa
Wheat: trigo
When concerning: quando se trata de, quando levamos em consideração
Whence: donde
Whenever: toda vez que, sempre que, a qualquer momento
Where is it?: onde é?
Whereabouts: paradeiro
Whereas (contraste, oposição): ao passo que, enquanto que, enquanto
Wherefore: por que, para que
Wherever: onde quer que
Whether... or: se... ou, quer... quer
Whether: se
Whew: ufa
Which one: qual
Which way: qual caminho?, por onde?
Whichever: qualquer que
While: enquanto, ao passo que, enquanto que
Whist: apito
Whistle: assobiar, apitar, apito, assobio
Whistling: assobio
White: clara, branco
Who else: quem mais?
Whoever: quem quer que
Whole bread: pão integral
Whole milk: leite integral
Whole Picture: prisma geral, imagem completa
Wholly: inteiramente
Whoop: grito, gritar, vaiar
Whooping-cough: coqueluche 
Whose: de quem, cujo, cuja
Whosever: quem quer que
Why is that?: por que isso?
Wicked: mau
Wide open: de par em par, bem aberto
Widespread: flagrante
Widow: viúva
Widower: viúvo
Wig: peruca
Will be enough: será suficiente
Will do: será suficiente
Will it be: será
Will that be: será
Will: testamento, vontade
Willing: disposto a, inclinado
Wind energy: energia eólica
Wind: vento; enroscar-se, serpear; dar corda (ao relógio), enrolar
Windowpane: vidraça
Windshield wiper: limpador de para brisa
Windshield: para brisa
Wink: piscadela
Winning: vencedor, vitória, cativante
Winsome: cativante
Wire: fio, arame, telegrafar
Wisdom: sabedoria
Wisely: sabiamente
Wit: sagacidade, inteligência
Witch: feiticeira
With a view to: com a intenção de
With great pleasure: com muito prazer
With regard to: quanto a
Withdraw: sacar, retirar, abster-se
Withdrawals: saques, retiradas
Wither: para onde
Within arm's reach: de fácil acesso
Within reach of: ao alcance de
Within: dentro de, ao alcance de, dentro dos limites de, na medida de
Without stint: sem limites
Witness: testemunhar, testemunha
Wizard: feiticeiro
Woe: ai
Womanish: feminino, afeminado
Womanlike: feminil
Womanly: feminil, mulheril, afeminado
Womb: útero
Wonder: ter curiosidade em saber, admirar; maravilha, perguntar-se
Wonderful: maravilhoso, excelente
Wooden spoon: colher de pau
Wooden: de madeira
Wool: lã
Woolen: de lã
Wordrobe: guarda-roupa
Work out: malhar, fazer exercício, elaborar, calcular
Work the party out: fazer a festa acontecer
Work two hours at a stretch: trabalhar duas horas a fio
Work: trabalhar, funcionar
Working day: dia de trabalho
Workman: operário
Works wonders: faz milagres
Worldwide: mundial
Worn-out: gasto, exausto
Worry about: preocupar com
Worry with: preocupar com
Worship: adorar
Worth while: valioso, que vale a pena
Worth: valor, no valor de, que vale a pena, valer
Worthy: digno
Wound: ferida (aberta, exposta), ferimento
Wow: puxa
Wrap it up: embrulhar
Wrap: embrulhar
Wreath: coroa, grinalda
Wreck: ruína, naufrágio
Wreckage: destroços
Wrest: arrancar, arrebatar
Wrestle: lutar, engalfinhar-se
Wretched: desventurado
Wring: espremer, torcer
Wrist: pulso
Wrong way: contramão
Wrong: erro (adjetivo, mais abrangente)
Wry: torto, enviesado
Yard: pátio, quintal, jarda, jardim
Yatch: iate
Yeah: sim
Yell: grito, berro, gritar
Yellow car: táxi
Yellowish: amarelado
Yet: já, ainda, contudo, mas, porém 
Yield: ceder
Yippee: viva
Yolk: gema
Yonder: além, acolá
You are about to: você está prestes a
You are allowed: você ter permissão
You are to blame: você é culpado
You can't miss it: impossível você não ver
You'd better: é melhor você
You're done: você está acabado
Young: jovem, novo (pessoas)
Youngster: jovem, criança
You're welcome: de nada
Zip (Zone Improvement Plan) code: Cep
Zucchini: abobrinha
1


